AAGCGGCGCCA -> AGCGGCGCCAC
TCCCAATCCCG -> CCCAATCCCGC
GCGTTTTCACC -> CGTTTTCACCA
ACAATGGCAGG -> CAATGGCAGGA
CGGAAGGTTGC -> GGAAGGTTGCG
CCCGCATCGGT -> CCGCATCGGTA
CGTCAACCAGA -> GTCAACCAGAA
TATTCATGCAT -> ATTCATGCATG
TCATGTTTCGC -> CATGTTTCGCA
ATACGTACCAG -> TACGTACCAGA
GTACGGAGTTA -> TACGGAGTTAA
TAGTTTTTTAT -> AGTTTTTTATG
CGTAAGCAATG -> GTAAGCAATGA
GTTCCTTCCTG -> TTCCTTCCTGA
CTAAACGTCAA -> TAAACGTCAAT
AGTGTCGAGCT -> GTGTCGAGCTA
AAACACCGCGC -> AACACCGCGCA
TATGGTTCCGC -> ATGGTTCCGCT
CTGGCGTTTTC -> TGGCGTTTTCA
TACCCGGAAGA -> ACCCGGAAGAC
CTATATATTTT -> TATATATTTTC
TGGAGCGATTT -> GGAGCGATTTG
GCCCGCATCGG -> CCCGCATCGGT
TGCCTTTGTCA -> GCCTTTGTCAT
GACCTGACTGA -> ACCTGACTGAA
ACAAATCGAGG -> CAAATCGAGGA
GTGGACCAAAA -> TGGACCAAAAA
ACCGAGTTGCT -> CCGAGTTGCTG
TGGCAGGAGAT -> GGCAGGAGATC
TAGTCAGATGC -> AGTCAGATGCG
CGGCGCATCAA -> GGCGCATCAAC
CTTCTGCCCTA -> TTCTGCCCTAG
TTCATGCATGT -> TCATGCATGTT
CATTGGTGTAC -> ATTGGTGTACG
ATATTGGCATC -> TATTGGCATCT
TCAGCGCCAGC -> CAGCGCCAGCA
ACGTAGATTAA -> CGTAGATTAAG
GCAGGAGATCT -> CAGGAGATCTC
GCACTGGACCT -> CACTGGACCTT
CGAGGAAACTC -> GAGGAAACTCC
TCCGCGGACTG -> CCGCGGACTGC
TCTCATGTTTC -> CTCATGTTTCG
AATACTTAATC -> ATACTTAATCG
CAACAGGCTAT -> AACAGGCTATA
GACGCCTGCAA -> ACGCCTGCAAC
CCCCACGCACT -> CCCACGCACTG
AACGGATCGTA -> ACGGATCGTAC
GACTTTTTCGT -> ACTTTTTCGTC
AGGGCGCAAGA -> GGGCGCAAGAG
GTACGCCCACC -> TACGCCCACCA
TGCCGTCAACC -> GCCGTCAACCA
CGAAAACGGGC -> GAAAACGGGCT
AATCTGCTGGT -> ATCTGCTGGTC
CACTGGACCTT -> ACTGGACCTTG
TTACATAGGAT -> TACATAGGATT
GACAAATCGAG -> ACAAATCGAGG
GTGTCGAGCTA -> TGTCGAGCTAT
CTTTGGAATTT -> TTTGGAATTTT
GACACAATACT -> ACACAATACTT
CTCCCGCCAAT -> TCCCGCCAATC
TCGTCGTGGGG -> CGTCGTGGGGC
TCAAGGTGCGA -> CAAGGTGCGAG
TTACCGAGTTG -> TACCGAGTTGC
GGGCGACTCTG -> GGCGACTCTGG
AAAGGGAGTAG -> AAGGGAGTAGA
TTTATAGTTAC -> TTATAGTTACC
TTGTCTTCACA -> TGTCTTCACAT
TAGACATACGA -> AGACATACGAC
ACATTAGAAAA -> CATTAGAAAAT
GGCCCCTCATC -> GCCCCTCATCT
CTAAGTCACCA -> TAAGTCACCAG
GGAAGCGTATT -> GAAGCGTATTC
CGCGCCCGTAA -> GCGCCCGTAAG
CGCTCTACGTA -> GCTCTACGTAG
CATAGGCTCAA -> ATAGGCTCAAG
CACCCTTTTAT -> ACCCTTTTATA
GGGTCAAGGTC -> GGTCAAGGTCG
ATCTGCTGGTC -> TCTGCTGGTCA
GACGGATCTTC -> ACGGATCTTCT
TACCTGGCGTT -> ACCTGGCGTTT
ATGTATATACG -> TGTATATACGT
ATGGACTATAT -> TGGACTATATA
TGGCTAAACCA -> GGCTAAACCAT
TCGAGGAAACT -> CGAGGAAACTC
TAGGATTGACT -> AGGATTGACTA
AGGGCTGAATC -> GGGCTGAATCG
CCAGCCTCTAA -> CAGCCTCTAAG
ATCCCGCTTAT -> TCCCGCTTATG
CATACCCCGAG -> ATACCCCGAGA
CAGATGCGGTA -> AGATGCGGTAG
GCCTGCTCGCT -> CCTGCTCGCTC
AGAGACCTAGT -> GAGACCTAGTT
CCAGAGGACTT -> CAGAGGACTTT
TCGGCCCATGG -> CGGCCCATGGG
GTCTGTAGCGG -> TCTGTAGCGGA
GTCTTATTACC -> TCTTATTACCC
CGTCCCTAGTC -> GTCCCTAGTCC
ACCCTGAGGGA -> CCCTGAGGGAA
TGTCCTTCGAT -> GTCCTTCGATT
CCTACCCGGAA -> CTACCCGGAAG
CTATACGACCG -> TATACGACCGA
TTGTGTCCTTC -> TGTGTCCTTCG
CATATTGTGCC -> ATATTGTGCCT
TCTTGATGTCC -> CTTGATGTCCA
CCCCGAGATAG -> CCCGAGATAGT
TCGGTACAAAT -> CGGTACAAATA
GCATTGGCCGT -> CATTGGCCGTT
TTCGTCGATCG -> TCGTCGATCGA
TCCGATGGACT -> CCGATGGACTA
GGGCATGTATA -> GGCATGTATAT
CAGAATATCTC -> AGAATATCTCA
ATGGTTCCGCT -> TGGTTCCGCTG
CCGTCCGCGGA -> CGTCCGCGGAC
AGGCTGTGATC -> GGCTGTGATCC
CAATTCACGCA -> AATTCACGCAG
CTGGACCTTGT -> TGGACCTTGTC
GCGGGTCTGTT -> CGGGTCTGTTC
AATTTTTAAAC -> ATTTTTAAACG
CTTATCTGGAT -> TTATCTGGATA
GTCAATTGTAC -> TCAATTGTACG
GTTAAGCAGGC -> TTAAGCAGGCT
CTTCGATTGGC -> TTCGATTGGCA
CTACGCATGAT -> TACGCATGATT
TGACATGGAAG -> GACATGGAAGC
ATTACACTCTA -> TTACACTCTAT
TGTCTTCACAT -> GTCTTCACATG
ACCGACCACTC -> CCGACCACTCC
ACCCCGGAGAC -> CCCCGGAGACT
TCCGGGGACTC -> CCGGGGACTCA
TTGTGCCTGCT -> TGTGCCTGCTC
GTTCCGATGGA -> TTCCGATGGAC
TAAACGTCAAT -> AAACGTCAATT
CCTTTTATAGT -> CTTTTATAGTT
TCTCCCTACCC -> CTCCCTACCCG
CTTTGTCATAT -> TTTGTCATATT
ACACTCTATGC -> CACTCTATGCC
TAGGACATACC -> AGGACATACCC
CTCAGGTATTC -> TCAGGTATTCA
ATGCGGTAGCC -> TGCGGTAGCCG
CCGTCAACCAG -> CGTCAACCAGA
AAACGGGCTGG -> AACGGGCTGGC
GTGTCCTTCGA -> TGTCCTTCGAT
CCCTAGTCCTC -> CCTAGTCCTCA
GGAAATGGCGC -> GAAATGGCGCG
CCAATCGGCCC -> CAATCGGCCCA
TGGTTCCGCTG -> GGTTCCGCTGG
CTTCTTCGCTC -> TTCTTCGCTCC
CTCTTGATGTC -> TCTTGATGTCC
CAAGTCCTATA -> AAGTCCTATAC
AATCCCGCTTA -> ATCCCGCTTAT
AGTTGTGAACC -> GTTGTGAACCG
GAGAGACGGGA -> AGAGACGGGAG
ACCCTTTTACA -> CCCTTTTACAT
CTGGTCAATTG -> TGGTCAATTGT
ATTGGCTAAAC -> TTGGCTAAACC
AGGTATTCATT -> GGTATTCATTA
TCTTTGGAATT -> CTTTGGAATTT
CGTCGTGGGGC -> GTCGTGGGGCG
TCGTACGTAGA -> CGTACGTAGAT
TATCTGGATAT -> ATCTGGATATG
CCGATGGACTA -> CGATGGACTAT
ACGTCACTAAT -> CGTCACTAATG
GACCGACCACT -> ACCGACCACTC
GCCTTGTGTCC -> CCTTGTGTCCT
CTTTTTCGTCG -> TTTTTCGTCGA
GCCGTTATAAG -> CCGTTATAAGC
AGGTCGTCGTG -> GGTCGTCGTGG
CGCTTATGCCG -> GCTTATGCCGT
GACGCAGTTAT -> ACGCAGTTATG
AATAGGTCCAT -> ATAGGTCCATA
TGACCTGACTG -> GACCTGACTGA
CCATAGACATA -> CATAGACATAC
CGAGTTGCTGG -> GAGTTGCTGGC
ACTAGGCTTCG -> CTAGGCTTCGA
ACATACGACGC -> CATACGACGCC
GGCGCCACAGA -> GCGCCACAGAA
GGAGCGATTTG -> GAGCGATTTGT
GCGCAAGAGAC -> CGCAAGAGACC
GATGTCCAAGT -> ATGTCCAAGTC
CCTTTGTCATA -> CTTTGTCATAT
CCCTTTTACAT -> CCTTTTACATA
TCGACTAGGCT -> CGACTAGGCTT
TGGTGAGGGGA -> GGTGAGGGGAT
TAGTTGTGAAC -> AGTTGTGAACC
TATAAGCGGGT -> ATAAGCGGGTC
AGTCTATGTCA -> GTCTATGTCAG
TGGCCTACGCA -> GGCCTACGCAT
CGATCAGCCAT -> GATCAGCCATT
TTATTGTAAGC -> TATTGTAAGCG
CCGGGGTATCC -> CGGGGTATCCT
TTATCGAAGGA -> TATCGAAGGAA
GTTGCTGGCCC -> TTGCTGGCCCC
CGCAGTTATGA -> GCAGTTATGAC
TCTCACATGGC -> CTCACATGGCT
CCATTCGCCTT -> CATTCGCCTTG
CGCATCGGTAC -> GCATCGGTACA
CCCCGGAGACT -> CCCGGAGACTC
ATCTCACGAAA -> TCTCACGAAAA
AAACATTAGAA -> AACATTAGAAA
GCGTAGTGCTT -> CGTAGTGCTTA
ACTATAGACAA -> CTATAGACAAG
GGAAGCGTAGC -> GAAGCGTAGCT
ACCTAGTTGTG -> CCTAGTTGTGA
TGTGCCTGCTC -> GTGCCTGCTCG
TCGACCCCGGA -> CGACCCCGGAG
TCTACCTGGCG -> CTACCTGGCGT
ATCAACAGGCT -> TCAACAGGCTA
CATTACGCCGT -> ATTACGCCGTC
TCACATGGCTC -> CACATGGCTCC
TGCTCGCTCTA -> GCTCGCTCTAC
GGTAGCCGGGG -> GTAGCCGGGGT
AATATCTCATG -> ATATCTCATGT
CTATCAACAGG -> TATCAACAGGC
CGTGTACGCCC -> GTGTACGCCCA
TACGCCCACCA -> ACGCCCACCAT
TCAAGGTCGTC -> CAAGGTCGTCG
AGCTACGGAAG -> GCTACGGAAGG
ATTCATTACAC -> TTCATTACACT
GATGCCCTTCT -> ATGCCCTTCTG
ATTACGCCGTC -> TTACGCCGTCG
CGCATCAACAT -> GCATCAACATA
CGCGCCCCGTC -> GCGCCCCGTCC
ACTCCGGGGAC -> CTCCGGGGACT
GCCCTAGGCTG -> CCCTAGGCTGT
CTGGTCAGTAC -> TGGTCAGTACA
CTCATGTTTCG -> TCATGTTTCGC
CACATGGCTCC -> ACATGGCTCCC
GCCTACGCATG -> CCTACGCATGA
TACGCATGATT -> ACGCATGATTG
AGAACCCTATC -> GAACCCTATCA
TAATTGGCTAA -> AATTGGCTAAA
AACATGCGGGG -> ACATGCGGGGT
GAGAGGGCGCA -> AGAGGGCGCAA
AGGCATATTGG -> GGCATATTGGC
TGCTGGCCCCT -> GCTGGCCCCTC
TTACACTCTAT -> TACACTCTATG
GCATCAACATA -> CATCAACATAG
AATGGCAGGAG -> ATGGCAGGAGA
GCCGTCAACCA -> CCGTCAACCAG
CATTGGCCGTT -> ATTGGCCGTTG
GAGTTGCTGGC -> AGTTGCTGGCC
AGATGCGGTAG -> GATGCGGTAGC
CAGGCTTGCAC -> AGGCTTGCACT
CCCCTTCATGG -> CCCTTCATGGC
AAGCGTAGCTA -> AGCGTAGCTAG
GGCATGTATAT -> GCATGTATATA
GCTTATGCCGT -> CTTATGCCGTT
GCATTACGCCG -> CATTACGCCGT
TGTTCCGATGG -> GTTCCGATGGA
ACGCCGTCGGA -> CGCCGTCGGAC
GTCAGCGCCAG -> TCAGCGCCAGC
TTGCGGTCGGG -> TGCGGTCGGGC
GAGTGTCGAGC -> AGTGTCGAGCT
AAGTCTATGTC -> AGTCTATGTCA
TCCAAGTCTAT -> CCAAGTCTATG
CTGTCGGGATA -> TGTCGGGATAA
AGGACTTTTTC -> GGACTTTTTCG
AGTCACCAGAG -> GTCACCAGAGG
CGGAAGCGTAT -> GGAAGCGTATT
CGCCAATCGGC -> GCCAATCGGCC
TAAACCATTGG -> AAACCATTGGC
GGACTGCCTTT -> GACTGCCTTTG
TACAAGTCCTA -> ACAAGTCCTAT
TCACCTCGTCT -> CACCTCGTCTG
CGTACGTAGAT -> GTACGTAGATT
AGACTGTGGAC -> GACTGTGGACC
CAAAGGGAGTA -> AAAGGGAGTAG
AACCCTTTTAC -> ACCCTTTTACA
TCGCAGAGGCG -> CGCAGAGGCGC
GTTACCGAGTT -> TTACCGAGTTG
ACAAATAGGTC -> CAAATAGGTCC
CGGCGCCACAG -> GGCGCCACAGA
AGCAATGAGAA -> GCAATGAGAAC
GCGTGTACGCC -> CGTGTACGCCC
CTTATGCCGTT -> TTATGCCGTTA
CATAGGATTGA -> ATAGGATTGAC
ATGGAAGCGTA -> TGGAAGCGTAG
CTGTAGGGCTG -> TGTAGGGCTGA
CCTCAGGTATT -> CTCAGGTATTC
GGAGACGGATC -> GAGACGGATCT
TGAAGGAGACG -> GAAGGAGACGG
CTGCCTGCTTC -> TGCCTGCTTCT
TAGTGCTTATC -> AGTGCTTATCT
GGCTGAATCGA -> GCTGAATCGAG
CAGGACTCTTC -> AGGACTCTTCG
ATAAGCGGGTC -> TAAGCGGGTCT
AGCCTCAGGTA -> GCCTCAGGTAT
CAAACATTAGA -> AAACATTAGAA
ACCATTGGCAC -> CCATTGGCACT
AGTAGACGGAA -> GTAGACGGAAG
GCTAGTTTTTT -> CTAGTTTTTTA
TGCTGTCTTAT -> GCTGTCTTATT
TCAACAGGCTA -> CAACAGGCTAT
AACTGACCCTG -> ACTGACCCTGA
GAGGCGCGAAA -> AGGCGCGAAAA
TCAATTGTACG -> CAATTGTACGG
CGCTCCCCACA -> GCTCCCCACAG
TGGACCTTGTC -> GGACCTTGTCT
TAGGCTCAAGG -> AGGCTCAAGGT
AGACACAATAC -> GACACAATACT
TTCGCTCCCCA -> TCGCTCCCCAC
TATATACGTCA -> ATATACGTCAA
GTAGGGCTGAA -> TAGGGCTGAAT
GAAATTTTTAA -> AAATTTTTAAA
ATCGAAGGAAC -> TCGAAGGAACA
CATTACACTCT -> ATTACACTCTA
CCCATGGGAGA -> CCATGGGAGAG
CACTATAGACA -> ACTATAGACAA
AGGGGATTTAT -> GGGGATTTATC
TCCAGCCTCTA -> CCAGCCTCTAA
TAGAAAATAAC -> AGAAAATAACC
TTTCGTCCCTA -> TTCGTCCCTAG
CTCCAGCCTCT -> TCCAGCCTCTA
TCCCTAGTCCT -> CCCTAGTCCTC
GGTGTACGGCG -> GTGTACGGCGC
GTAACATGCGG -> TAACATGCGGG
AGTAACATGCG -> GTAACATGCGG
ATGGCCTACGC -> TGGCCTACGCA
AATGCAGGCAT -> ATGCAGGCATA
CCTGAGGGAAA -> CTGAGGGAAAT
TGTTAAACACC -> GTTAAACACCG
TGTTCGGCGCG -> GTTCGGCGCGC
GGCGCATCAAC -> GCGCATCAACA
AGGACATACCC -> GGACATACCCC
ATGCCCTTCTG -> TGCCCTTCTGC
CTCCCCCACGC -> TCCCCCACGCA
CAGTTATGACA -> AGTTATGACAT
CTCCCTACCCG -> TCCCTACCCGG
AGGCAGCTCGC -> GGCAGCTCGCA
ACCATGGTGAG -> CCATGGTGAGG
AGGCTTCGACC -> GGCTTCGACCC
CCAGGACTCTT -> CAGGACTCTTC
ACTCCACATAG -> CTCCACATAGG
GACCACTCCGG -> ACCACTCCGGG
GATATGGATGC -> ATATGGATGCC
GTAGAACGACG -> TAGAACGACGC
TACGGCGCATC -> ACGGCGCATCA
AGCGGAAAGAA -> GCGGAAAGAAA
GAGTTAAGCAG -> AGTTAAGCAGG
TTTTTTATGGT -> TTTTTATGGTT
TTGGTGTACGG -> TGGTGTACGGC
TTCCTTCCTGA -> TCCTTCCTGAC
TATTCTGTCGG -> ATTCTGTCGGG
GAAAATAACCT -> AAAATAACCTC
TTGATGTCCAA -> TGATGTCCAAG
ACAGAATATCT -> CAGAATATCTC
AATGGAAAAAT -> ATGGAAAAATC
AAGTCACCAGA -> AGTCACCAGAG
CTAGGCAAAGG -> TAGGCAAAGGG
TATTGTGCCTG -> ATTGTGCCTGC
GGCTCAAGGTG -> GCTCAAGGTGC
GCAACTCTCTC -> CAACTCTCTCC
GTCCTATACGT -> TCCTATACGTA
GCGGGGTCAAG -> CGGGGTCAAGG
CATGCATGTTA -> ATGCATGTTAA
GCGCCAAGTTA -> CGCCAAGTTAG
TACTTAATCGG -> ACTTAATCGGA
GACATGGAAGC -> ACATGGAAGCG
TGAGAGACGGG -> GAGAGACGGGA
TATAGTTACCG -> ATAGTTACCGA
CTGTTATAAGC -> TGTTATAAGCG
GGGAGTAGACG -> GGAGTAGACGG
CCCTATCAACA -> CCTATCAACAG
GAGCGATTTGT -> AGCGATTTGTT
ACTTATTCATG -> CTTATTCATGC
GGATTTATCGA -> GATTTATCGAA
CTTTTACATAG -> TTTTACATAGG
ATCGGAAGCGT -> TCGGAAGCGTA
ACGAAAACCCT -> CGAAAACCCTT
CCCCTCATCTA -> CCCTCATCTAA
TTCCTGACGCA -> TCCTGACGCAG
GCTCCCGCCAA -> CTCCCGCCAAT
ATGAGGTACAT -> TGAGGTACATT
CACCATGGTGA -> ACCATGGTGAG
CACGTCACTAA -> ACGTCACTAAT
TTTCGCATTGG -> TTCGCATTGGC
CGATCGATCAG -> GATCGATCAGC
CGCCCGTAAGC -> GCCCGTAAGCA
GGGCGTCACCT -> GGCGTCACCTC
CGTTGCTGTCT -> GTTGCTGTCTT
TCTAAGTCACC -> CTAAGTCACCA
GTACGTAGATT -> TACGTAGATTA
GCCTCAGGTAT -> CCTCAGGTATT
GCAATGAGAAC -> CAATGAGAACC
TGGGAGAGGGC -> GGGAGAGGGCG
CCATTGGCACT -> CATTGGCACTG
CTCCACATAGG -> TCCACATAGGG
GAAAACGGGCT -> AAAACGGGCTG
CAGCGCCAGCA -> AGCGCCAGCAA
CAATGAGAACC -> AATGAGAACCC
GTCAATTCACG -> TCAATTCACGC
TGGCTCCCCCA -> GGCTCCCCCAC
CCGGAGACTCC -> CGGAGACTCCA
GGCAGGAGATC -> GCAGGAGATCT
GCGCCACAGAA -> CGCCACAGAAT
AAATCGAGGAA -> AATCGAGGAAA
GCCCACCATGG -> CCCACCATGGT
TCGGAAGCGTA -> CGGAAGCGTAT
AAGGGAGTAGA -> AGGGAGTAGAC
TGTATATACGT -> GTATATACGTC
ACTGTTATTGT -> CTGTTATTGTA
GTTCCGCTGGA -> TTCCGCTGGAG
GGTCGGGCGTC -> GTCGGGCGTCA
TAAGCAGGCTT -> AAGCAGGCTTG
GCTGTGATCCA -> CTGTGATCCAC
TCAGTACAAGT -> CAGTACAAGTC
CAGGAGATCTC -> AGGAGATCTCA
CGCATTGGCCG -> GCATTGGCCGT
TCATCCCAATC -> CATCCCAATCC
CCTTCGATTGG -> CTTCGATTGGC
CGTCAATTCAC -> GTCAATTCACG
ATCGAGGAAAC -> TCGAGGAAACT
AGGAGACGGAT -> GGAGACGGATC
TAGGGCATGTA -> AGGGCATGTAT
GTGTACGGCGC -> TGTACGGCGCA
TAGGCTTCGAC -> AGGCTTCGACC
CGCACTGGACC -> GCACTGGACCT
CCAAGTTAGAC -> CAAGTTAGACT
GTTTCGCATTG -> TTTCGCATTGG
TTGAGAGACGG -> TGAGAGACGGG
TCTGCCCTAGG -> CTGCCCTAGGC
TATACTTATTC -> ATACTTATTCA
CACCTCGTCTG -> ACCTCGTCTGT
CGAGCTATACG -> GAGCTATACGA
GGCTGCCTGCT -> GCTGCCTGCTT
CCTATACGTAC -> CTATACGTACC
CCGTCCTGTAG -> CGTCCTGTAGG
CTGCGTAACGG -> TGCGTAACGGA
TTTATCGAAGG -> TTATCGAAGGA
CTAGTTGTGAA -> TAGTTGTGAAC
TCGTGGGGCGA -> CGTGGGGCGAC
AGCCTCTAAGT -> GCCTCTAAGTC
GCATCGGTACA -> CATCGGTACAA
TCGGGATAATT -> CGGGATAATTG
CAACCAGGACT -> AACCAGGACTC
AGTACAAGTCC -> GTACAAGTCCT
CATTAGAAAAT -> ATTAGAAAATA
CGGGGTCAAGG -> GGGGTCAAGGT
CGCTGGAGCGA -> GCTGGAGCGAT
TCCTATACGTA -> CCTATACGTAC
TCCCCCACGCA -> CCCCCACGCAC
AAACGTAGGCA -> AACGTAGGCAG
ACCACTATAGA -> CCACTATAGAC
TTTTAAACGTA -> TTTAAACGTAG
GCTGTCTTATT -> CTGTCTTATTA
CATGCGGGGTC -> ATGCGGGGTCA
TCACTAATGCA -> CACTAATGCAG
GGAGAGGGCGC -> GAGAGGGCGCA
CCACTCCGGGG -> CACTCCGGGGA
TCATTACACTC -> CATTACACTCT
GCAGTTATGAC -> CAGTTATGACA
CATTTCGTCCC -> ATTTCGTCCCT
CACATAGGGCA -> ACATAGGGCAT
GGAGTTAAGCA -> GAGTTAAGCAG
TGCTGGTCAGT -> GCTGGTCAGTA
TAAGCGGCGCC -> AAGCGGCGCCA
TGACCCTGAGG -> GACCCTGAGGG
GGTATCCTGCG -> GTATCCTGCGT
CTATAGTCAGA -> TATAGTCAGAT
AGTTACCGAGT -> GTTACCGAGTT
ATCCACCCTTT -> TCCACCCTTTT
CGAGATAGTAG -> GAGATAGTAGA
GGCGCCAAGTT -> GCGCCAAGTTA
GCGGTCGGGCG -> CGGTCGGGCGT
AAAACCCTTTT -> AAACCCTTTTA
TATTGGCATCT -> ATTGGCATCTT
TCACATGAGGT -> CACATGAGGTA
ACATTTCGTCC -> CATTTCGTCCC
CGGAGTTAAGC -> GGAGTTAAGCA
TTAATCGGAAG -> TAATCGGAAGC
TATTTTCGCTC -> ATTTTCGCTCC
AATCGAGGAAA -> ATCGAGGAAAC
CTACCCGGAAG -> TACCCGGAAGA
AGCGGCGCCAC -> GCGGCGCCACA
GCAGAGGCGCG -> CAGAGGCGCGA
AGTTAGACTGT -> GTTAGACTGTT
ATAGTTACCGA -> TAGTTACCGAG
GCGCATCAACA -> CGCATCAACAT
GGCAGCTCGCA -> GCAGCTCGCAG
GCAAAGGGAGT -> CAAAGGGAGTA
CCTCATCTAAC -> CTCATCTAACC
GCGCGCTTAGT -> CGCGCTTAGTA
CTACCTGGCGT -> TACCTGGCGTT
CCTATCAACAG -> CTATCAACAGG
CCTGCAACTCT -> CTGCAACTCTC
CATGGTGAGGG -> ATGGTGAGGGG
AGCAGTGCCCG -> GCAGTGCCCGC
CCCTGAGGGAA -> CCTGAGGGAAA
TCGGGCGTCAC -> CGGGCGTCACC
TGGATATGGAT -> GGATATGGATG
TGTTCCTTCCT -> GTTCCTTCCTG
TTAGACTGTTA -> TAGACTGTTAT
CTGACCCTGAG -> TGACCCTGAGG
CCTAGGCTGTG -> CTAGGCTGTGA
CGACGCCTGCA -> GACGCCTGCAA
TGTACGGAGTT -> GTACGGAGTTA
GGCCTACGCAT -> GCCTACGCATG
TATACGACCGA -> ATACGACCGAC
ACGGAAGGTTG -> CGGAAGGTTGC
GCAGGCTTGCA -> CAGGCTTGCAC
GGGATAATTGG -> GGATAATTGGC
AGGCTCAAGGT -> GGCTCAAGGTG
TTAAACGTAGG -> TAAACGTAGGC
AGAGTGTCGAG -> GAGTGTCGAGC
TGAGGGGATTT -> GAGGGGATTTA
CCTGTAGGGCT -> CTGTAGGGCTG
TCCACCCTTTT -> CCACCCTTTTA
GCGCGCCCCGT -> CGCGCCCCGTC
AGAGGCGCGAA -> GAGGCGCGAAA
TATTGTAAGCG -> ATTGTAAGCGT
TCACGCAGACA -> CACGCAGACAC
CGCACTCTCAC -> GCACTCTCACA
ATGTCAGCGCC -> TGTCAGCGCCA
CGATTTGTTCC -> GATTTGTTCCG
GGAAGCCTCAG -> GAAGCCTCAGG
GGTGCGAGCTA -> GTGCGAGCTAG
CTGTCTTATTA -> TGTCTTATTAC
GGCTTGCACTC -> GCTTGCACTCG
CATGATTGACC -> ATGATTGACCT
TATTCATTACA -> ATTCATTACAC
AAGCAGGCTTG -> AGCAGGCTTGC
TCACGAAAACC -> CACGAAAACCC
CTGAATCGAGA -> TGAATCGAGAG
AACTCCAACCA -> ACTCCAACCAG
AAGCAATGAGA -> AGCAATGAGAA
CTACGGAAGGT -> TACGGAAGGTT
TGGACCAAAAA -> GGACCAAAAAG
CTCGCGTGTAC -> TCGCGTGTACG
TTCGACTAGGC -> TCGACTAGGCT
GGAAGGTTGCG -> GAAGGTTGCGG
AGTGCCCGCAT -> GTGCCCGCATC
GTGTACGCCCA -> TGTACGCCCAC
GCTGGCCCCTC -> CTGGCCCCTCA
TCAGGTATTCA -> CAGGTATTCAT
ACTCTGGTCAA -> CTCTGGTCAAT
GGTACATTTCG -> GTACATTTCGT
TCTTCTCTCTT -> CTTCTCTCTTG
CACCATTGGTG -> ACCATTGGTGT
GTTGCGGTCGG -> TTGCGGTCGGG
TTCATGGCCTA -> TCATGGCCTAC
TATGCCGTTAT -> ATGCCGTTATA
GTACAAATAGG -> TACAAATAGGT
GGATGCCCTTC -> GATGCCCTTCT
TAGGCAGCTCG -> AGGCAGCTCGC
GATCGATCAGC -> ATCGATCAGCC
GTCGGGCGTCA -> TCGGGCGTCAC
TCTGTCGGGAT -> CTGTCGGGATA
GCCTCTAAGTC -> CCTCTAAGTCA
TCCCCACAGCT -> CCCCACAGCTA
TACGTAGATTA -> ACGTAGATTAA
GGGAAATGGCG -> GGAAATGGCGC
CCACAGCTACG -> CACAGCTACGG
CCCGAGATAGT -> CCGAGATAGTA
AGGTTGCGGTC -> GGTTGCGGTCG
GCGGACTGCCT -> CGGACTGCCTT
AGAAATTTTTA -> GAAATTTTTAA
CGCTCCCGCCA -> GCTCCCGCCAA
CAATGGCAGGA -> AATGGCAGGAG
CTCTACGTAGG -> TCTACGTAGGC
GGAGCTAGAAT -> GAGCTAGAATT
TGAACCGTGAC -> GAACCGTGACC
AGAACGACGCA -> GAACGACGCAC
TATGCCGTCAA -> ATGCCGTCAAC
TATAGACAAGC -> ATAGACAAGCA
ATGCCGTCAAC -> TGCCGTCAACC
AAAATAACCTC -> AAATAACCTCC
GCAAGAGACCT -> CAAGAGACCTA
CGACCCCGGAG -> GACCCCGGAGA
CCACCATGGTG -> CACCATGGTGA
AACGGGCTGGC -> ACGGGCTGGCG
GTTATAAGCGG -> TTATAAGCGGG,TTATAAGCGGC
CGTCCGCGGAC -> GTCCGCGGACT
GAAACTCCAAC -> AAACTCCAACC
TCACGTCACTA -> CACGTCACTAA
CGCATTACGCC -> GCATTACGCCG
TACAACCGTCC -> ACAACCGTCCT
TCGCGTGTACG -> CGCGTGTACGC
GTACAAGTCCT -> TACAAGTCCTA
ACTATATATTT -> CTATATATTTT
CCCGCCAATCG -> CCGCCAATCGG
AGACTCCACAT -> GACTCCACATA
CTGTGGACCAA -> TGTGGACCAAA
ACAGGCTATAG -> CAGGCTATAGT
TTCTTCGCTCC -> TCTTCGCTCCC
GTCACCTCGTC -> TCACCTCGTCT
ATAGACATACG -> TAGACATACGA
ACTCTTCGACT -> CTCTTCGACTA
GAATTTTGTCT -> AATTTTGTCTA
CCCACAGCTAC -> CCACAGCTACG
TGATTGACCTG -> GATTGACCTGA
CATCTTTGGAA -> ATCTTTGGAAT
TCGAAGGAACA -> CGAAGGAACAT
ATGACATGGAA -> TGACATGGAAG
CAACATAGGAC -> AACATAGGACA
TATACGTCAAA -> ATACGTCAAAC
GGCTCCCCCAC -> GCTCCCCCACG
CCTGCTCGCTC -> CTGCTCGCTCT
CACTAATGCAG -> ACTAATGCAGG
GCCACAGAATA -> CCACAGAATAT
CCAGACAAATC -> CAGACAAATCG
TCAATTCACGC -> CAATTCACGCA
ATAGGCTCAAG -> TAGGCTCAAGG
GGGCTGGCGCC -> GGCTGGCGCCA
TAAGTCACCAG -> AAGTCACCAGA
CACTCCGGGGA -> ACTCCGGGGAC
AGAGACGGGAG -> GAGACGGGAGC
AGGTCCATAGA -> GGTCCATAGAC
TAGAACGACGC -> AGAACGACGCA
GGCCCATGGGA -> GCCCATGGGAG
AGGGAAATGGC -> GGGAAATGGCG
GCTACGGAAGG -> CTACGGAAGGT
CCCGCTTATGC -> CCGCTTATGCC
GGATATGGATG -> GATATGGATGC
CCGCGCATTAC -> CGCGCATTACG
CGATGGACTAT -> GATGGACTATA
CTGCAACTCTC -> TGCAACTCTCT
CTCCGGGGACT -> TCCGGGGACTC
GTGACCCCTTC -> TGACCCCTTCA
GCGTAGCTAGT -> CGTAGCTAGTT
GGTTACAACCG -> GTTACAACCGT
CGTCTGTAGCG -> GTCTGTAGCGG
TTATTCATGCA -> TATTCATGCAT
GGCTATAGTCA -> GCTATAGTCAG
AGACGGAAGCC -> GACGGAAGCCT
ATATATTTTCG -> TATATTTTCGC
ATTCGCCTTGT -> TTCGCCTTGTG
CTGACGCAGTT -> TGACGCAGTTA
ACCCGGAAGAC -> CCCGGAAGACT
GTAGCGGAAAG -> TAGCGGAAAGA
CGGTAGCCGGG -> GGTAGCCGGGG
TTACCCGCGCC -> TACCCGCGCCC
TCCTTCGATTG -> CCTTCGATTGG
CTCCCCACAGC -> TCCCCACAGCT
GTGCTTATCTG -> TGCTTATCTGG
AATTCACGCAG -> ATTCACGCAGA
GTCCTTCGATT -> TCCTTCGATTG
CGTATTCTGTC -> GTATTCTGTCG
GACTGTTATAA -> ACTGTTATAAG
CAAGCAGTGCC -> AAGCAGTGCCC
TTGCACTCGCG -> TGCACTCGCGT
CACTCTCACAT -> ACTCTCACATG
GCTATACGACC -> CTATACGACCG
ACGACGCCTGC -> CGACGCCTGCA
AGTTAAGCAGG -> GTTAAGCAGGC
GCCCATGGGAG -> CCCATGGGAGA
CAACCGTCCTG -> AACCGTCCTGT
ATAGGACATAC -> TAGGACATACC
GTGATCCACCC -> TGATCCACCCT
AAGGAACATAG -> AGGAACATAGG
TAGACAAGCAG -> AGACAAGCAGT
GATGTTCCTTC -> ATGTTCCTTCC
GGCGCAAGAGA -> GCGCAAGAGAC
ATTGGCCGTTG -> TTGGCCGTTGC
GACTCACGTCA -> ACTCACGTCAC
TGTCTTATTAC -> GTCTTATTACC
CCTTGTCTTCA -> CTTGTCTTCAC
CTCCAACCAGG -> TCCAACCAGGA
CCACATAGGGC -> CACATAGGGCA
ACTAAACGTCA -> CTAAACGTCAA
CGCATGATTGA -> GCATGATTGAC
CCTAGTTGTGA -> CTAGTTGTGAA
GGTACAAATAG -> GTACAAATAGG
CCCTAGGCTGT -> CCTAGGCTGTG
ATAAGCGGCGC -> TAAGCGGCGCC
CTCGCTCTACG -> TCGCTCTACGT
TCGGCGCGCTT -> CGGCGCGCTTA
GCTTCGACCCC -> CTTCGACCCCG
CTAGGCTGTGA -> TAGGCTGTGAT
GGTGAGGGGAT -> GTGAGGGGATT
GACTCTTCGAC -> ACTCTTCGACT
CTCATCTAACC -> TCATCTAACCA
TAAGTATACTT -> AAGTATACTTA
CACCGCGCATT -> ACCGCGCATTA
ACGGGCTGGCG -> CGGGCTGGCGC
CATGGCTCCCC -> ATGGCTCCCCC
ACTCTCACATG -> CTCTCACATGG
TTCGCCTTGTG -> TCGCCTTGTGT
TGGCGTTTTCA -> GGCGTTTTCAC
GGAAAAATCTG -> GAAAAATCTGC
CGGAAGACTGT -> GGAAGACTGTG
GGACCAAAAAG -> GACCAAAAAGA
TCGAGCTATAC -> CGAGCTATACG
TAACCTCCAGC -> AACCTCCAGCC
TTCCGATGGAC -> TCCGATGGACT
GGGGTATCCTG -> GGGTATCCTGC
AAGAAATTTTT -> AGAAATTTTTA
CAGGCTATAGT -> AGGCTATAGTC
TTTCACCATTG -> TTCACCATTGG
GGCGTCACCTC -> GCGTCACCTCG
TAGCCGGGGTA -> AGCCGGGGTAT
CTATGTCAGCG -> TATGTCAGCGC
GAACTGACCCT -> AACTGACCCTG
TGACGCAGTTA -> GACGCAGTTAT
GAATCGAGAGT -> AATCGAGAGTG
AGATCTCACGA -> GATCTCACGAA
TCAACATAGGA -> CAACATAGGAC
TTGCTGGCCCC -> TGCTGGCCCCT
CTGCTCGCTCT -> TGCTCGCTCTA
CGTGGGGCGAC -> GTGGGGCGACT
CCTGACTGAAG -> CTGACTGAAGG
AGCTAGTTTTT -> GCTAGTTTTTT
CAACTCTCTCC -> AACTCTCTCCC
CGCAGACACAA -> GCAGACACAAT
AGTTTTTTATG -> GTTTTTTATGG
AGGCTTGCACT -> GGCTTGCACTC
GGTCCATAGAC -> GTCCATAGACA
CAAGAGACCTA -> AAGAGACCTAG
TAGCGGAAAGA -> AGCGGAAAGAA
GCATATTGTGC -> CATATTGTGCC
GATTAAGTATA -> ATTAAGTATAC
CGGACTGCCTT -> GGACTGCCTTT
ATTGTAAGCGT -> TTGTAAGCGTA
GCCATTCGCCT -> CCATTCGCCTT
GGGGCGACTCT -> GGGCGACTCTG
ACTTTTTCGTC -> CTTTTTCGTCG
CTTCATGGCCT -> TTCATGGCCTA
CATAGGGCATG -> ATAGGGCATGT
GCCAGCAATGG -> CCAGCAATGGA
ACGTACCAGAC -> CGTACCAGACA
ACAAGCAGTGC -> CAAGCAGTGCC
GTCACTAATGC -> TCACTAATGCA
CTGCTTCTTCG -> TGCTTCTTCGC
GCATCTTTGGA -> CATCTTTGGAA
ATCTTTGGAAT -> TCTTTGGAATT
ATTGACTAAAC -> TTGACTAAACG
TCCCGCTTATG -> CCCGCTTATGC
TCACCAGAGGA -> CACCAGAGGAC
GGCGCGAAAAC -> GCGCGAAAACG
ATTGGTGTACG -> TTGGTGTACGG
ACAATACTTAA -> CAATACTTAAT
TTGACCTGACT -> TGACCTGACTG
TGCCGTTATAA -> GCCGTTATAAG
ATAATTGGCTA -> TAATTGGCTAA
GCTATAGTCAG -> CTATAGTCAGA
CTGCTGGTCAG -> TGCTGGTCAGT
ATCGGTACAAA -> TCGGTACAAAT
ACATAGGCTCA -> CATAGGCTCAA
ACCTTGTCTTC -> CCTTGTCTTCA
AGGATTGACTA -> GGATTGACTAA
CCCCCACGCAC -> CCCCACGCACT
CGGTCGGGCGT -> GGTCGGGCGTC
AGGCTGCCTGC -> GGCTGCCTGCT
GGCGCGCTTAG -> GCGCGCTTAGT
GGGTATCCTGC -> GGTATCCTGCG
CGTCGGACAAT -> GTCGGACAATG
AGGTGCGAGCT -> GGTGCGAGCTA
TTTGTCATATT -> TTGTCATATTT
GTCAGATGCGG -> TCAGATGCGGT
GTATTCTGTCG -> TATTCTGTCGG
ATCAGCCATTC -> TCAGCCATTCG
ACCGCGCATTA -> CCGCGCATTAC
ACCTGGCGTTT -> CCTGGCGTTTT
TTCACCATTGG -> TCACCATTGGT
GGAATTTTGTC -> GAATTTTGTCT
CAATACTTAAT -> AATACTTAATC
GGGATTTATCG -> GGATTTATCGA
CGTAGGCAGCT -> GTAGGCAGCTC
TACGACCGACC -> ACGACCGACCA
ATCTAACCACT -> TCTAACCACTA
TAGCTAGTTTT -> AGCTAGTTTTT
TGGCACTGTTA -> GGCACTGTTAT
TCCATAGACAT -> CCATAGACATA
CAATCGGCCCA -> AATCGGCCCAT
GACAATGGCAG -> ACAATGGCAGG
CACGAAAACCC -> ACGAAAACCCT
TTTTTATGGTT -> TTTTATGGTTC
TCTCTCTTGAT -> CTCTCTTGATG
TCATCTAACCA -> CATCTAACCAC
ATACGACCGAC -> TACGACCGACC
ATGGGAGAGGG -> TGGGAGAGGGC
GTCTATGTCAG -> TCTATGTCAGC
TGTACGCCCAC -> GTACGCCCACC
CGGAAGCCTCA -> GGAAGCCTCAG
CGTAACGGATC -> GTAACGGATCG
ATTTGAGAGAC -> TTTGAGAGACG
AACCCTATCAA -> ACCCTATCAAC
CGGGGACTCAC -> GGGGACTCACG
AGGAAACTCCA -> GGAAACTCCAA
TTGGCATCTTT -> TGGCATCTTTG
CATATTTGAGA -> ATATTTGAGAG
GCTGGTCAGTA -> CTGGTCAGTAC
GGTTGCGGTCG -> GTTGCGGTCGG
AAATAGGTCCA -> AATAGGTCCAT
TCGCTCCCCAC -> CGCTCCCCACA
TCTGGTCAATT -> CTGGTCAATTG
AAGTCCTATAC -> AGTCCTATACG
TAGTTACCGAG -> AGTTACCGAGT
ATACTTATTCA -> TACTTATTCAT
CCGTAAGCAAT -> CGTAAGCAATG
AAGGTCGTCGT -> AGGTCGTCGTG
GCACTCGCGTG -> CACTCGCGTGT
CACTGTTATTG -> ACTGTTATTGT
TCCTTCCTGAC -> CCTTCCTGACG
TTTCGCTCCCG -> TTCGCTCCCGC
TACATAGGATT -> ACATAGGATTG
TTTAAACGTAG -> TTAAACGTAGG
TACGCCGTCGG -> ACGCCGTCGGA
TGGCATCTTTG -> GGCATCTTTGG
TTGTAAGCGTA -> TGTAAGCGTAG
ACATGGAAGCG -> CATGGAAGCGT
GTCACCAGAGG -> TCACCAGAGGA
CAGCCATTCGC -> AGCCATTCGCC
AGTTATGACAT -> GTTATGACATG
GACTCGGTTAC -> ACTCGGTTACA
GACTGTGGACC -> ACTGTGGACCA
CATGGGAGAGG -> ATGGGAGAGGG
CGTCACCTCGT -> GTCACCTCGTC
AAAACGGGCTG -> AAACGGGCTGG
CACGCAGACAC -> ACGCAGACACA
GTGCGAGCTAG -> TGCGAGCTAGG
GATGGACTATA -> ATGGACTATAT
GGGTCTGTTCG -> GGTCTGTTCGG
GTCGTCGTGGG -> TCGTCGTGGGG
AGGGCATGTAT -> GGGCATGTATA
TGAGGTACATT -> GAGGTACATTT
GTTTTCACCAT -> TTTTCACCATT
CCGTTATAAGC -> CGTTATAAGCG
GTTACAACCGT -> TTACAACCGTC
CTCGGTTACAA -> TCGGTTACAAC
GACCAAAAAGA -> ACCAAAAAGAC
GCTTCTTCGCT -> CTTCTTCGCTC
TGGAATTTTGT -> GGAATTTTGTC
GGATTGACTAA -> GATTGACTAAA
GCTAGGCAAAG -> CTAGGCAAAGG
GTCGTGGGGCG -> TCGTGGGGCGA
ATCAACATAGG -> TCAACATAGGA
GATTTATCGAA -> ATTTATCGAAG
TTCACATGAGG -> TCACATGAGGT
CTGGCGCCAAG -> TGGCGCCAAGT
ATCCCAATCCC -> TCCCAATCCCG
ACACAATACTT -> CACAATACTTA
CGCGTGTACGC -> GCGTGTACGCC
TAGGTCCATAG -> AGGTCCATAGA
TCGTCCCTAGT -> CGTCCCTAGTC
GCGTATTCTGT -> CGTATTCTGTC
ATACGACGCCT -> TACGACGCCTG
AGACTGTTATA -> GACTGTTATAA
TGACTAAACGT -> GACTAAACGTC
ATTAGAAAATA -> TTAGAAAATAA
ACTAATGCAGG -> CTAATGCAGGC
GCCAATCGGCC -> CCAATCGGCCC
TAAACACCGCG -> AAACACCGCGC
CGCCTTGTGTC -> GCCTTGTGTCC
AAAAAGACTCG -> AAAAGACTCGG
ACTGACCCTGA -> CTGACCCTGAG
GTTATTGTAAG -> TTATTGTAAGC
CATGGCCTACG -> ATGGCCTACGC
GACTGCCTTTG -> ACTGCCTTTGT
AAATTTTTAAA -> AATTTTTAAAC
TGTTTCGCATT -> GTTTCGCATTG
CCGTTGCTGTC -> CGTTGCTGTCT
ACGGAAGCCTC -> CGGAAGCCTCA
ACTGAAGGAGA -> CTGAAGGAGAC
CCTGCTTCTTC -> CTGCTTCTTCG
TTTTCGTCGAT -> TTTCGTCGATC
TCGGTTACAAC -> CGGTTACAACC
CAGCTCGCAGA -> AGCTCGCAGAG
TAGTCCTCATC -> AGTCCTCATCC
GGATCGTACGT -> GATCGTACGTA
TGCCCTTCTGC -> GCCCTTCTGCC
ATGAGAACCCT -> TGAGAACCCTA
AGCCATTCGCC -> GCCATTCGCCT
CGATTGGCATA -> GATTGGCATAT
ATTGGCATCTT -> TTGGCATCTTT
AGACTCGGTTA -> GACTCGGTTAC
CGACCGACCAC -> GACCGACCACT
AGAGGACTTTT -> GAGGACTTTTT
CAAATCGAGGA -> AAATCGAGGAA
ACTGTTATAAG -> CTGTTATAAGC
ACAACCGTCCT -> CAACCGTCCTG
TAACCACTATA -> AACCACTATAG
GAGGGGATTTA -> AGGGGATTTAT
CTCAAGGTGCG -> TCAAGGTGCGA
CAGTGCCCGCA -> AGTGCCCGCAT
GGCGTTTTCAC -> GCGTTTTCACC
TGATCCACCCT -> GATCCACCCTT
TCAGCCATTCG -> CAGCCATTCGC
ACGCACTGGAC -> CGCACTGGACC
CCAACCAGGAC -> CAACCAGGACT
CTTCGCTCCCC -> TTCGCTCCCCA
TTCGTCCCTAG -> TCGTCCCTAGT
ATGGTGAGGGG -> TGGTGAGGGGA
CAAGTTAGACT -> AAGTTAGACTG
GAGACGGATCT -> AGACGGATCTT
GCATGTATATA -> CATGTATATAC
TTCCGCTGGAG -> TCCGCTGGAGC
TTTACATAGGA -> TTACATAGGAT
TGCTTATCTGG -> GCTTATCTGGA
GGTATTCATTA -> GTATTCATTAC
TATCTCATGTT -> ATCTCATGTTT
GAGCTAGGCAA -> AGCTAGGCAAA
AACGTCAATTC -> ACGTCAATTCA
GGTCAGTACAA -> GTCAGTACAAG
CACATGAGGTA -> ACATGAGGTAC
AGACATACGAC -> GACATACGACG
TAGTAGAACGA -> AGTAGAACGAC
AACTCTCTCCC -> ACTCTCTCCCT
GAACATAGGCT -> AACATAGGCTC
CTCTAAGTCAC -> TCTAAGTCACC
TGCATGTTAAA -> GCATGTTAAAC
GTTTTTTATGG -> TTTTTTATGGT
TCTCTTGATGT -> CTCTTGATGTC
TAGATTAAGTA -> AGATTAAGTAT
AAGTTAGACTG -> AGTTAGACTGT
AAGGAGACGGA -> AGGAGACGGAT
TCCACATAGGG -> CCACATAGGGC
GACATACGACG -> ACATACGACGC
CGGGTCTGTTC -> GGGTCTGTTCG
TATTACCCGCG -> ATTACCCGCGC
GTCCTGTAGGG -> TCCTGTAGGGC
GCTGGAGCGAT -> CTGGAGCGATT
AGAACTGACCC -> GAACTGACCCT
CCCGCGCCCGT -> CCGCGCCCGTA
CGTACCAGACA -> GTACCAGACAA
AGCAGGCTTGC -> GCAGGCTTGCA
GACAAGCAGTG -> ACAAGCAGTGC
TCCCTACCCGG -> CCCTACCCGGA
TGGCGCGCCCC -> GGCGCGCCCCG
TCCTGCGTAAC -> CCTGCGTAACG
GACATACCCCG -> ACATACCCCGA
CATGTTAAACA -> ATGTTAAACAC
ATGCGGGGTCA -> TGCGGGGTCAA
GCAGACACAAT -> CAGACACAATA
CGAGAGTGTCG -> GAGAGTGTCGA
AGCGATTTGTT -> GCGATTTGTTC
CTTCGACTAGG -> TTCGACTAGGC
CTAACCACTAT -> TAACCACTATA
AGTCAGATGCG -> GTCAGATGCGG
CCGGAAGACTG -> CGGAAGACTGT
CCCACCATGGT -> CCACCATGGTG
GGACTTTTTCG -> GACTTTTTCGT
CTGGCCCCTCA -> TGGCCCCTCAT
GGTCGTCGTGG -> GTCGTCGTGGG
AACCGTGACCC -> ACCGTGACCCC
AGCGTAGTGCT -> GCGTAGTGCTT
CCAATCCCGCT -> CAATCCCGCTT
CAGCCTCTAAG -> AGCCTCTAAGT
ACGGGAGCTAG -> CGGGAGCTAGA
GGCTAAACCAT -> GCTAAACCATT
CTTATTCATGC -> TTATTCATGCA
TTATAAGCGGG -> TATAAGCGGGT
TTATAAGCGGC -> TATAAGCGGCG
GAGGGCGCAAG -> AGGGCGCAAGA
AACCAGGACTC -> ACCAGGACTCT
GCGCATTACGC -> CGCATTACGCC
GAGGAAACTCC -> AGGAAACTCCA
TCTGGATATGG -> CTGGATATGGA
GTCATATTTGA -> TCATATTTGAG
TTAAACACCGC -> TAAACACCGCG
AGCTCGCAGAG -> GCTCGCAGAGG
ATATGGATGCC -> TATGGATGCCC
ACATGGCTCCC -> CATGGCTCCCC
ACCTCCAGCCT -> CCTCCAGCCTC
GAAAACCCTTT -> AAAACCCTTTT
TTGGAATTTTG -> TGGAATTTTGT
GGAACATAGGC -> GAACATAGGCT
CAGGTATTCAT -> AGGTATTCATT
GCGCCCGTAAG -> CGCCCGTAAGC
GCGGCGCCACA -> CGGCGCCACAG
CCGCTTATGCC -> CGCTTATGCCG
AATTGGCTAAA -> ATTGGCTAAAC
TTGGCACTGTT -> TGGCACTGTTA
CTCGCAGAGGC -> TCGCAGAGGCG
ATGCATGTTAA -> TGCATGTTAAA
CCCTTCATGGC -> CCTTCATGGCC
TTGGCATATTG -> TGGCATATTGT
GAGATAGTAGA -> AGATAGTAGAA
CCAGCAATGGA -> CAGCAATGGAA
CGACTAGGCTT -> GACTAGGCTTC
TCTTATTACCC -> CTTATTACCCG
TCTTCACATGA -> CTTCACATGAG
TAACATGCGGG -> AACATGCGGGG
GCCAAGTTAGA -> CCAAGTTAGAC
GCGGAAAGAAA -> CGGAAAGAAAT
GCACTCTCACA -> CACTCTCACAT
TCAAACATTAG -> CAAACATTAGA
ACAAGTCCTAT -> CAAGTCCTATA
GTAGGCAGCTC -> TAGGCAGCTCG
CATCGGTACAA -> ATCGGTACAAA
TCCTGTAGGGC -> CCTGTAGGGCT
AACGACGCACT -> ACGACGCACTC
ACGGAGTTAAG -> CGGAGTTAAGC
CTACGTAGGCT -> TACGTAGGCTG
GAGACCTAGTT -> AGACCTAGTTG
AGCAATGGAAA -> GCAATGGAAAA
GTACCAGACAA -> TACCAGACAAA
CACTCTATGCC -> ACTCTATGCCG
GTATACTTATT -> TATACTTATTC
AGTCCTCATCC -> GTCCTCATCCC
GACGGGAGCTA -> ACGGGAGCTAG
GTAACGGATCG -> TAACGGATCGT
ATTGACCTGAC -> TTGACCTGACT
CTTAATCGGAA -> TTAATCGGAAG
GCTCCCCACAG -> CTCCCCACAGC
CACCAGAGGAC -> ACCAGAGGACT
CGGAGACTCCA -> GGAGACTCCAC
ACCCCGAGATA -> CCCCGAGATAG
TTCGATTGGCA -> TCGATTGGCAT
GGCCGTTGCTG -> GCCGTTGCTGT
TGAGGGAAATG -> GAGGGAAATGG
CGAAGGAACAT -> GAAGGAACATA
CACAATACTTA -> ACAATACTTAA
GCCTGCTTCTT -> CCTGCTTCTTC
GCAGTGCCCGC -> CAGTGCCCGCA
CGTTTTCACCA -> GTTTTCACCAT
CCTCCAGCCTC -> CTCCAGCCTCT
CGCGGACTGCC -> GCGGACTGCCT
TAGTAACATGC -> AGTAACATGCG
CAGCTACGGAA -> AGCTACGGAAG
CGCAGAGGCGC -> GCAGAGGCGCG
GTACGGCGCAT -> TACGGCGCATC
GCCTTTGTCAT -> CCTTTGTCATA
TCCTGACGCAG -> CCTGACGCAGT
CATGTTTCGCA -> ATGTTTCGCAT
GAACCCTATCA -> AACCCTATCAA
TTGTGAACCGT -> TGTGAACCGTG
AGACGGGAGCT -> GACGGGAGCTA
AACAGGCTATA -> ACAGGCTATAG
GTAGATTAAGT -> TAGATTAAGTA
TACACTCTATG -> ACACTCTATGC
CGCCCACCATG -> GCCCACCATGG
GTCGGACAATG -> TCGGACAATGG
GAGGGAAATGG -> AGGGAAATGGC
TGTCGAGCTAT -> GTCGAGCTATA
AAACCATTGGC -> AACCATTGGCA
ACCCCTTCATG -> CCCCTTCATGG
GATGCGGTAGC -> ATGCGGTAGCC
TTATAGTTACC -> TATAGTTACCG
TGCGGTAGCCG -> GCGGTAGCCGG
ATTTCGTCCCT -> TTTCGTCCCTA
CCCTCATCTAA -> CCTCATCTAAC
TAGACGGAAGC -> AGACGGAAGCC
CTCTATGCCGT -> TCTATGCCGTC
GACCTAGTTGT -> ACCTAGTTGTG
TACGGAGTTAA -> ACGGAGTTAAG
TGCAACTCTCT -> GCAACTCTCTC
ACCCTTTTATA -> CCCTTTTATAG
CCCGTAAGCAA -> CCGTAAGCAAT
AATTTTGTCTA -> ATTTTGTCTAC
GATCTTCTCTC -> ATCTTCTCTCT
ACTCGGTTACA -> CTCGGTTACAA
GCGAGCTAGGC -> CGAGCTAGGCA
TCAGATGCGGT -> CAGATGCGGTA
CATATTGGCAT -> ATATTGGCATC
AACCATTGGCA -> ACCATTGGCAC
GATCTCACGAA -> ATCTCACGAAA
GAGCTAGAATT -> AGCTAGAATTT
TTTTACATAGG -> TTTACATAGGA
AGCGGGTCTGT -> GCGGGTCTGTT
GGCGCGCCCCG -> GCGCGCCCCGT
ATACCCCGAGA -> TACCCCGAGAT
ATTCATGCATG -> TTCATGCATGT
CATACGACGCC -> ATACGACGCCT
GGACATACCCC -> GACATACCCCG
GATCCACCCTT -> ATCCACCCTTT
CAGAACTGACC -> AGAACTGACCC
ACAGCTACGGA -> CAGCTACGGAA
CCGCGGACTGC -> CGCGGACTGCC
GGAAGACTGTG -> GAAGACTGTGG
GCCCCTCATCT -> CCCCTCATCTA
CGTCGATCGAT -> GTCGATCGATC
GGAGACTCCAC -> GAGACTCCACA
TGAGAACCCTA -> GAGAACCCTAT
CCTGACGCAGT -> CTGACGCAGTT
CGTCAAACATT -> GTCAAACATTA
AGGACTCTTCG -> GGACTCTTCGA
GACCCTGAGGG -> ACCCTGAGGGA
TGGCATATTGT -> GGCATATTGTG
ACTCTATGCCG -> CTCTATGCCGT
TTGTCATATTT -> TGTCATATTTG
CGGATCGTACG -> GGATCGTACGT
ACGTCAAACAT -> CGTCAAACATT
AGACGGATCTT -> GACGGATCTTC
ATAGGATTGAC -> TAGGATTGACT
TGGAAGCGTAG -> GGAAGCGTAGC
TGGGGCGACTC -> GGGGCGACTCT
CTCTCCCTACC -> TCTCCCTACCC
TTTGTTCCGAT -> TTGTTCCGATG
GACCCCGGAGA -> ACCCCGGAGAC
TTTTTAAACGT -> TTTTAAACGTA
TCGAGAGTGTC -> CGAGAGTGTCG
GACTCCACATA -> ACTCCACATAG
GCTCTACGTAG -> CTCTACGTAGG
TCTAACCACTA -> CTAACCACTAT
AAATGGCGCGC -> AATGGCGCGCC
TGAATCGAGAG -> GAATCGAGAGT
GTATTCATTAC -> TATTCATTACA
ACCTGACTGAA -> CCTGACTGAAG
CTGTTCGGCGC -> TGTTCGGCGCG
CCTCATCCCAA -> CTCATCCCAAT
TGCAGGCATAT -> GCAGGCATATT
GTTCGGCGCGC -> TTCGGCGCGCT
TTTGTCTACCT -> TTGTCTACCTG
AAGGTGCGAGC -> AGGTGCGAGCT
CGGTTACAACC -> GGTTACAACCG
GTATATACGTC -> TATATACGTCA
TGTAGCGGAAA -> GTAGCGGAAAG
CCATGGGAGAG -> CATGGGAGAGG
CGTAGTGCTTA -> GTAGTGCTTAT
CAAGGTCGTCG -> AAGGTCGTCGT
CCACTATAGAC -> CACTATAGACA
GTAGGCTGCCT -> TAGGCTGCCTG
CCTCTAAGTCA -> CTCTAAGTCAC
ATGTTAAACAC -> TGTTAAACACC
ATAGTCAGATG -> TAGTCAGATGC
CCCTTTTATAG -> CCTTTTATAGT
TTCTGCCCTAG -> TCTGCCCTAGG
AAGACTGTGGA -> AGACTGTGGAC
GCAGCTCGCAG -> CAGCTCGCAGA
GCCGGGGTATC -> CCGGGGTATCC
ACGGATCTTCT -> CGGATCTTCTC
GTCAACCAGAA -> TCAACCAGAAC
TGTAAGCGTAG -> GTAAGCGTAGT
ACGCAGTTATG -> CGCAGTTATGA
CTTAGTAACAT -> TTAGTAACATG
CCTACGCATGA -> CTACGCATGAT
AGGCGCGAAAA -> GGCGCGAAAAC
CTTCCTGACGC -> TTCCTGACGCA
TGTGTCCTTCG -> GTGTCCTTCGA
GTAGCTAGTTT -> TAGCTAGTTTT
CCAAGTCTATG -> CAAGTCTATGT
CGTAGATTAAG -> GTAGATTAAGT
TTGTACGGAGT -> TGTACGGAGTT
CAGCAATGGAA -> AGCAATGGAAA
CTGAGGGAAAT -> TGAGGGAAATG
GCCTGCAACTC -> CCTGCAACTCT
GAAGGAGACGG -> AAGGAGACGGA
GCTCGCTCTAC -> CTCGCTCTACG
TCTGCTGGTCA -> CTGCTGGTCAG
GCTGCCTGCTT -> CTGCCTGCTTC
GGCATATTGTG -> GCATATTGTGC
ATTGTACGGAG -> TTGTACGGAGT
TACGGAAGGTT -> ACGGAAGGTTG
ATGGAAAAATC -> TGGAAAAATCT
TCATGGCCTAC -> CATGGCCTACG
AGCTAGGCAAA -> GCTAGGCAAAG
ACCTCGTCTGT -> CCTCGTCTGTA
ATAACCTCCAG -> TAACCTCCAGC
TTACAACCGTC -> TACAACCGTCC
CGAGCTAGGCA -> GAGCTAGGCAA
ATGGATGCCCT -> TGGATGCCCTT
ACCAGGACTCT -> CCAGGACTCTT
CACAGCTACGG -> ACAGCTACGGA
CCTCGTCTGTA -> CTCGTCTGTAG
TTGACTAAACG -> TGACTAAACGT
AGGCAAAGGGA -> GGCAAAGGGAG
AGATAGTAGAA -> GATAGTAGAAC
GTCTTCACATG -> TCTTCACATGA
GAAGCGTAGCT -> AAGCGTAGCTA
GCTAGAATTTC -> CTAGAATTTCA
GCGTCACCTCG -> CGTCACCTCGT
TATTTGAGAGA -> ATTTGAGAGAC
GCACTGTTATT -> CACTGTTATTG
GTAAGCAATGA -> TAAGCAATGAG
CGGATCTTCTC -> GGATCTTCTCT
CGGACAATGGC -> GGACAATGGCA
TATATTTTCGC -> ATATTTTCGCT
CTTTTATAGTT -> TTTTATAGTTA
TAAGCGTAGTG -> AAGCGTAGTGC
CAAGTCTATGT -> AAGTCTATGTC
GTCTACCTGGC -> TCTACCTGGCG
GTCCATAGACA -> TCCATAGACAT
TGGTCAATTGT -> GGTCAATTGTA
CAAGGTGCGAG -> AAGGTGCGAGC
CATTGGCACTG -> ATTGGCACTGT
GAAAAATCTGC -> AAAAATCTGCT
GGACTATATAT -> GACTATATATT
ACCAGAGGACT -> CCAGAGGACTT
ATATCTCATGT -> TATCTCATGTT
GACTAGGCTTC -> ACTAGGCTTCG
TACCGAGTTGC -> ACCGAGTTGCT
TGATGTCCAAG -> GATGTCCAAGT
TCCCGCCAATC -> CCCGCCAATCG
CCCGTCCGCGG -> CCGTCCGCGGA
TGCCCGCATCG -> GCCCGCATCGG
CTCTCTCCCTA -> TCTCTCCCTAC
TCGCATTGGCC -> CGCATTGGCCG
CTCACATGGCT -> TCACATGGCTC
TGTTATAAGCG -> GTTATAAGCGG
ATGTTTCGCAT -> TGTTTCGCATT
GCCCCGTCCGC -> CCCCGTCCGCG
ATCGTACGTAG -> TCGTACGTAGA
CTTGTCTTCAC -> TTGTCTTCACA
GAAGCGTATTC -> AAGCGTATTCT
ACCCGCGCCCG -> CCCGCGCCCGT
GCGAAAACGGG -> CGAAAACGGGC
GTCGATCGATC -> TCGATCGATCA
GTCGGGATAAT -> TCGGGATAATT
AGAGGGCGCAA -> GAGGGCGCAAG
GGCTTCGACCC -> GCTTCGACCCC
TCGATCGATCA -> CGATCGATCAG
GGTTCCGCTGG -> GTTCCGCTGGA
GGATAATTGGC -> GATAATTGGCT
GACGGAAGCCT -> ACGGAAGCCTC
ACGTCAATTCA -> CGTCAATTCAC
TCAACCAGAAC -> CAACCAGAACT
AGTTGCTGGCC -> GTTGCTGGCCC
TAAGCAATGAG -> AAGCAATGAGA
CACTCGCGTGT -> ACTCGCGTGTA
ACATAGGACAT -> CATAGGACATA
GCTTAGTAACA -> CTTAGTAACAT
GGCATATTGGC -> GCATATTGGCA
TCTCACGAAAA -> CTCACGAAAAC
GGAGTAGACGG -> GAGTAGACGGA
GCTGAATCGAG -> CTGAATCGAGA
CGTTATAAGCG -> GTTATAAGCGG
TGCGGTCGGGC -> GCGGTCGGGCG
GCTCGCAGAGG -> CTCGCAGAGGC
GATTGGCATAT -> ATTGGCATATT
GCTTGCACTCG -> CTTGCACTCGC
TCGCCTTGTGT -> CGCCTTGTGTC
ATATACGTCAA -> TATACGTCAAA
AACCACTATAG -> ACCACTATAGA
TACGTACCAGA -> ACGTACCAGAC
TATGTCAGCGC -> ATGTCAGCGCC
CTCTCTTGATG -> TCTCTTGATGT
TTAAGCAGGCT -> TAAGCAGGCTT
TGTGGACCAAA -> GTGGACCAAAA
TGCACTCGCGT -> GCACTCGCGTG
GTTAAACACCG -> TTAAACACCGC
GTGAGGGGATT -> TGAGGGGATTT
CCTTCTGCCCT -> CTTCTGCCCTA
TGGATGCCCTT -> GGATGCCCTTC
AGCTATACGAC -> GCTATACGACC
GCGCCAGCAAT -> CGCCAGCAATG
CTAATGCAGGC -> TAATGCAGGCA
AAACCCTTTTA -> AACCCTTTTAC
AACGTAGGCAG -> ACGTAGGCAGC
ACCAGAACTGA -> CCAGAACTGAC
TCTGTAGCGGA -> CTGTAGCGGAA
CGCAAGAGACC -> GCAAGAGACCT
TCGATTGGCAT -> CGATTGGCATA
TATGGATGCCC -> ATGGATGCCCT
ATAGTAGAACG -> TAGTAGAACGA
ATCCTGCGTAA -> TCCTGCGTAAC
GATCAGCCATT -> ATCAGCCATTC
ATGATTGACCT -> TGATTGACCTG
GTAGACGGAAG -> TAGACGGAAGC
CTCGTCTGTAG -> TCGTCTGTAGC
GGACCTTGTCT -> GACCTTGTCTT
GGGGTCAAGGT -> GGGTCAAGGTC
GCGACTCTGGT -> CGACTCTGGTC
GGCGACTCTGG -> GCGACTCTGGT
AGACCTAGTTG -> GACCTAGTTGT
TCGCTCTACGT -> CGCTCTACGTA
CTAGGCTTCGA -> TAGGCTTCGAC
TTATGCCGTTA -> TATGCCGTTAT
ACATGAGGTAC -> CATGAGGTACA
TCGTCTGTAGC -> CGTCTGTAGCG
GATAATTGGCT -> ATAATTGGCTA
TAATCGGAAGC -> AATCGGAAGCG
ATGTTCCTTCC -> TGTTCCTTCCT
CAACCAGAACT -> AACCAGAACTG
CCTTCATGGCC -> CTTCATGGCCT
CAGACACAATA -> AGACACAATAC
TAGGCTGCCTG -> AGGCTGCCTGC
TGCCTGCTCGC -> GCCTGCTCGCT
TTATCTGGATA -> TATCTGGATAT
GTCCCTAGTCC -> TCCCTAGTCCT
TGTCCAAGTCT -> GTCCAAGTCTA
AGTCCTATACG -> GTCCTATACGT
TCGTCGATCGA -> CGTCGATCGAT
ATTCTGTCGGG -> TTCTGTCGGGA
TACCCGCGCCC -> ACCCGCGCCCG
GTGCCTGCTCG -> TGCCTGCTCGC
CCGCCAATCGG -> CGCCAATCGGC
GATTGACTAAA -> ATTGACTAAAC
AAGCGTAGTGC -> AGCGTAGTGCT
GAGACGGGAGC -> AGACGGGAGCT
ATCTGGATATG -> TCTGGATATGG
CCCGGAGACTC -> CCGGAGACTCC
ACTCACGTCAC -> CTCACGTCACT
GGCATCTTTGG -> GCATCTTTGGA
GACCTTGTCTT -> ACCTTGTCTTC
AACACCGCGCA -> ACACCGCGCAT
ACGCCCACCAT -> CGCCCACCATG
TTTTATGGTTC -> TTTATGGTTCC
ACGGCGCATCA -> CGGCGCATCAA
ACTCGCGTGTA -> CTCGCGTGTAC
CATGAGGTACA -> ATGAGGTACAT
GGCAAAGGGAG -> GCAAAGGGAGT
GGATCTTCTCT -> GATCTTCTCTC
TACGTCAAACA -> ACGTCAAACAT
CTCACGAAAAC -> TCACGAAAACC
TTAGAAAATAA -> TAGAAAATAAC
ATTACCCGCGC -> TTACCCGCGCC
TAAGCGGGTCT -> AAGCGGGTCTG
GAAGGAACATA -> AAGGAACATAG
TTTCGTCGATC -> TTCGTCGATCG
CTTGATGTCCA -> TTGATGTCCAA
CGAAAACCCTT -> GAAAACCCTTT
CGCCCCGTCCG -> GCCCCGTCCGC
GCCGTCGGACA -> CCGTCGGACAA
GGGCGCAAGAG -> GGCGCAAGAGA
GCTGGCGCCAA -> CTGGCGCCAAG
AGCCGGGGTAT -> GCCGGGGTATC
ACGCATGATTG -> CGCATGATTGA
GTATCCTGCGT -> TATCCTGCGTA
CAATTGTACGG -> AATTGTACGGA
CTGTTATTGTA -> TGTTATTGTAA
CGACGCACTCT -> GACGCACTCTC
CGCGCTTAGTA -> GCGCTTAGTAA
CCCTACCCGGA -> CCTACCCGGAA
GTCAAGGTCGT -> TCAAGGTCGTC
AAAGACTCGGT -> AAGACTCGGTT
TTTTATAGTTA -> TTTATAGTTAC
TTGTCTACCTG -> TGTCTACCTGG
GTGCCCGCATC -> TGCCCGCATCG
TACAAATAGGT -> ACAAATAGGTC
AAGCAGTGCCC -> AGCAGTGCCCG
ATTTATCGAAG -> TTTATCGAAGG
CGCCAAGTTAG -> GCCAAGTTAGA
CCAGAACTGAC -> CAGAACTGACC
CTATAGACAAG -> TATAGACAAGC
CCGAGTTGCTG -> CGAGTTGCTGG
AATTGTACGGA -> ATTGTACGGAG
TCCTCATCCCA -> CCTCATCCCAA
TCACCATTGGT -> CACCATTGGTG
GGGGATTTATC -> GGGATTTATCG
GCTCCCCCACG -> CTCCCCCACGC
GAGCTATACGA -> AGCTATACGAC
ACGCACTCTCA -> CGCACTCTCAC
GCCCGTAAGCA -> CCCGTAAGCAA
TCTATGTCAGC -> CTATGTCAGCG
CGGCCCATGGG -> GGCCCATGGGA
TTAGTAACATG -> TAGTAACATGC
TTGGCCGTTGC -> TGGCCGTTGCT
CATGTATATAC -> ATGTATATACG
ACCAGACAAAT -> CCAGACAAATC
CATCTAACCAC -> ATCTAACCACT
CATGGAAGCGT -> ATGGAAGCGTA
GAAGCCTCAGG -> AAGCCTCAGGT
CTTCGACCCCG -> TTCGACCCCGG
GGTCAATTGTA -> GTCAATTGTAC
AAGAGACCTAG -> AGAGACCTAGT
CTGGATATGGA -> TGGATATGGAT
TCCGCTGGAGC -> CCGCTGGAGCG
TGTCAGCGCCA -> GTCAGCGCCAG
ACTTAATCGGA -> CTTAATCGGAA
TCTTCGACTAG -> CTTCGACTAGG
CGGGCTGGCGC -> GGGCTGGCGCC
CTAAACCATTG -> TAAACCATTGG
TTATGGTTCCG -> TATGGTTCCGC
GTGGGGCGACT -> TGGGGCGACTC
ACCGTGACCCC -> CCGTGACCCCT
AGAAAATAACC -> GAAAATAACCT
CCATTGGTGTA -> CATTGGTGTAC
AACCAGAACTG -> ACCAGAACTGA
CTAGTCCTCAT -> TAGTCCTCATC
CATAGACATAC -> ATAGACATACG
TGACTGAAGGA -> GACTGAAGGAG
AACCGTCCTGT -> ACCGTCCTGTA
CAAATAGGTCC -> AAATAGGTCCA
TTCGCTCCCGC -> TCGCTCCCGCC
CCACGCACTGG -> CACGCACTGGA
ATTGTGCCTGC -> TTGTGCCTGCT
CTGGAGCGATT -> TGGAGCGATTT
ATACTTAATCG -> TACTTAATCGG
GAACCGTGACC -> AACCGTGACCC
ATTGGCATATT -> TTGGCATATTG
ATCGATCAGCC -> TCGATCAGCCA
TCCAACCAGGA -> CCAACCAGGAC
GAAGACTGTGG -> AAGACTGTGGA
GAAAGAAATTT -> AAAGAAATTTT
AGAATATCTCA -> GAATATCTCAT
TTCTCTCTTGA -> TCTCTCTTGAT
AACATAGGACA -> ACATAGGACAT
AGCGTAGCTAG -> GCGTAGCTAGT
GAATATCTCAT -> AATATCTCATG
CAGACAAATCG -> AGACAAATCGA
GAGTAGACGGA -> AGTAGACGGAA
AAAGAAATTTT -> AAGAAATTTTT
ATCTTCTCTCT -> TCTTCTCTCTT
AGTGCTTATCT -> GTGCTTATCTG
CCGGGGACTCA -> CGGGGACTCAC
TTATTACCCGC -> TATTACCCGCG
CGTAGGCTGCC -> GTAGGCTGCCT
ATCGAGAGTGT -> TCGAGAGTGTC
GACTATATATT -> ACTATATATTT
TCTACGTAGGC -> CTACGTAGGCT
TTGGCTAAACC -> TGGCTAAACCA
GAGAACCCTAT -> AGAACCCTATC
GTTAGACTGTT -> TTAGACTGTTA
ACATGCGGGGT -> CATGCGGGGTC
CCCGGAAGACT -> CCGGAAGACTG
ACATAGGGCAT -> CATAGGGCATG
CAGTACAAGTC -> AGTACAAGTCC
TATCGAAGGAA -> ATCGAAGGAAC
TACGACGCCTG -> ACGACGCCTGC
GGTCAAGGTCG -> GTCAAGGTCGT
TGGTCAGTACA -> GGTCAGTACAA
TGTCATATTTG -> GTCATATTTGA
GTTGTGAACCG -> TTGTGAACCGT
CAGAGGCGCGA -> AGAGGCGCGAA
AGCGCCAGCAA -> GCGCCAGCAAT
CTAGTTTTTTA -> TAGTTTTTTAT
CCTGCGTAACG -> CTGCGTAACGG
GAACGACGCAC -> AACGACGCACT
CGTAGCTAGTT -> GTAGCTAGTTT
TGGTGTACGGC -> GGTGTACGGCG
CAGAGGACTTT -> AGAGGACTTTT
CCACAGAATAT -> CACAGAATATC
ATAGACAAGCA -> TAGACAAGCAG
AAACGTCAATT -> AACGTCAATTC
AGTAGAACGAC -> GTAGAACGACG
CGCCTGCAACT -> GCCTGCAACTC
CGGCGCGCTTA -> GGCGCGCTTAG
TCATGCATGTT -> CATGCATGTTA
AGACAAGCAGT -> GACAAGCAGTG
CGCGCATTACG -> GCGCATTACGC
CCAAAAAGACT -> CAAAAAGACTC
CATCCCAATCC -> ATCCCAATCCC
TTTATGGTTCC -> TTATGGTTCCG
CTTGCACTCGC -> TTGCACTCGCG
TCTCTCCCTAC -> CTCTCCCTACC
CTTGTGTCCTT -> TTGTGTCCTTC
TATAAGCGGCG -> ATAAGCGGCGC
ACGACGCACTC -> CGACGCACTCT
CCCAATCCCGC -> CCAATCCCGCT
GCAGGCATATT -> CAGGCATATTG
ATGCCGTTATA -> TGCCGTTATAA
GGGGACTCACG -> GGGACTCACGT
AAGCCTCAGGT -> AGCCTCAGGTA
GGACTCTTCGA -> GACTCTTCGAC
AAAATCTGCTG -> AAATCTGCTGG
TAGGCTGTGAT -> AGGCTGTGATC
TCTTCGCTCCC -> CTTCGCTCCCC
TGGCCGTTGCT -> GGCCGTTGCTG
AATAACCTCCA -> ATAACCTCCAG
TGTCGGGATAA -> GTCGGGATAAT
TACCCCGAGAT -> ACCCCGAGATA
CCGTGACCCCT -> CGTGACCCCTT
CTGACTGAAGG -> TGACTGAAGGA
ACCATTGGTGT -> CCATTGGTGTA
TGACCCCTTCA -> GACCCCTTCAT
CTCTCACATGG -> TCTCACATGGC
CCGTCGGACAA -> CGTCGGACAAT
ATGTCCAAGTC -> TGTCCAAGTCT
CCCTTCTGCCC -> CCTTCTGCCCT
CGACTCTGGTC -> GACTCTGGTCA
AAGGTTGCGGT -> AGGTTGCGGTC
GGGACTCACGT -> GGACTCACGTC
GCCCTTCTGCC -> CCCTTCTGCCC
TATACGTACCA -> ATACGTACCAG
GCTCAAGGTGC -> CTCAAGGTGCG
GGAAACTCCAA -> GAAACTCCAAC
TTCACGCAGAC -> TCACGCAGACA
TAGGGCTGAAT -> AGGGCTGAATC
TCGGACAATGG -> CGGACAATGGC
GGCTGGCGCCA -> GCTGGCGCCAA
CCGACCACTCC -> CGACCACTCCG
TATCAACAGGC -> ATCAACAGGCT
CCGCTGGAGCG -> CGCTGGAGCGA
GAAGGTTGCGG -> AAGGTTGCGGT
CTCTTCGACTA -> TCTTCGACTAG
ATTAAGTATAC -> TTAAGTATACT
TAGACTGTTAT -> AGACTGTTATA
TCTGTTCGGCG -> CTGTTCGGCGC
CTATGCCGTCA -> TATGCCGTCAA
TACCAGACAAA -> ACCAGACAAAT
ATAGGGCATGT -> TAGGGCATGTA
ATATTTTCGCT -> TATTTTCGCTC
ATAGGTCCATA -> TAGGTCCATAG
CTCTGGTCAAT -> TCTGGTCAATT
GGAGATCTCAC -> GAGATCTCACG
ACGACCGACCA -> CGACCGACCAC
GGCTGTGATCC -> GCTGTGATCCA
CAATCCCGCTT -> AATCCCGCTTA
GCGCGAAAACG -> CGCGAAAACGG
GTAAGCGTAGT -> TAAGCGTAGTG
AACATAGGCTC -> ACATAGGCTCA
ACTGGACCTTG -> CTGGACCTTGT
TGGCCCCTCAT -> GGCCCCTCATC
TGTGATCCACC -> GTGATCCACCC
CCATGGTGAGG -> CATGGTGAGGG
AACATTAGAAA -> ACATTAGAAAA
ACGCCTGCAAC -> CGCCTGCAACT
TAAACGTAGGC -> AAACGTAGGCA
CGGAAAGAAAT -> GGAAAGAAATT
AATGAGAACCC -> ATGAGAACCCT
AACCTCCAGCC -> ACCTCCAGCCT
ACATACCCCGA -> CATACCCCGAG
AAAAGACTCGG -> AAAGACTCGGT
TAACGGATCGT -> AACGGATCGTA
CTGCCCTAGGC -> TGCCCTAGGCT
GTCCGCGGACT -> TCCGCGGACTG
ACCACTCCGGG -> CCACTCCGGGG
GTCAAACATTA -> TCAAACATTAG
GCGCCCCGTCC -> CGCCCCGTCCG
GCATATTGGCA -> CATATTGGCAT
ATATTTGAGAG -> TATTTGAGAGA
CGTGACCCCTT -> GTGACCCCTTC
AGGGAGTAGAC -> GGGAGTAGACG
TGCGTAACGGA -> GCGTAACGGAT
AGACAAATCGA -> GACAAATCGAG
ATTTGTTCCGA -> TTTGTTCCGAT
TTTTTCGTCGA -> TTTTCGTCGAT
ACGTAGGCAGC -> CGTAGGCAGCT
CCCACGCACTG -> CCACGCACTGG
CCCCGTCCGCG -> CCCGTCCGCGG
GACTAAACGTC -> ACTAAACGTCA
GATTGACCTGA -> ATTGACCTGAC
CGGGATAATTG -> GGGATAATTGG
ATGCAGGCATA -> TGCAGGCATAT
GAAATGGCGCG -> AAATGGCGCGC
AATCGAGAGTG -> ATCGAGAGTGT
AATCGGCCCAT -> ATCGGCCCATG
TGCGGGGTCAA -> GCGGGGTCAAG
GGGAGAGGGCG -> GGAGAGGGCGC
CCGCATCGGTA -> CGCATCGGTAC
TTGTTCCGATG -> TGTTCCGATGG
GCATGATTGAC -> CATGATTGACC
GTGAACCGTGA -> TGAACCGTGAC
CTGAAGGAGAC -> TGAAGGAGACG
CACAGAATATC -> ACAGAATATCT
TTAAGTATACT -> TAAGTATACTT
CAATGGAAAAA -> AATGGAAAAAT
ACCCTATCAAC -> CCCTATCAACA
TCTATGCCGTC -> CTATGCCGTCA
GGACTCACGTC -> GACTCACGTCA
GGTCTGTTCGG -> GTCTGTTCGGC
TTATGACATGG -> TATGACATGGA
CGCCGTCGGAC -> GCCGTCGGACA
ATCTCATGTTT -> TCTCATGTTTC
ATACGTCAAAC -> TACGTCAAACA
ACTCCAACCAG -> CTCCAACCAGG
TTTTGTCTACC -> TTTGTCTACCT
CCTTTTACATA -> CTTTTACATAG
ACGCAGACACA -> CGCAGACACAA
TATCCTGCGTA -> ATCCTGCGTAA
GTCCAAGTCTA -> TCCAAGTCTAT
AAGCGGGTCTG -> AGCGGGTCTGT
TAATGCAGGCA -> AATGCAGGCAT
CCGCGCCCGTA -> CGCGCCCGTAA
TACATTTCGTC -> ACATTTCGTCC
GGAAAGAAATT -> GAAAGAAATTT
CTCATCCCAAT -> TCATCCCAATC
CGCCACAGAAT -> GCCACAGAATA
TGTCTACCTGG -> GTCTACCTGGC
ATTTTGTCTAC -> TTTTGTCTACC
ACACCGCGCAT -> CACCGCGCATT
CGCCAGCAATG -> GCCAGCAATGG
ATTGGCACTGT -> TTGGCACTGTT
GTCAGTACAAG -> TCAGTACAAGT
CTTCACATGAG -> TTCACATGAGG
GAGAGTGTCGA -> AGAGTGTCGAG
AGTATACTTAT -> GTATACTTATT
CAGGCATATTG -> AGGCATATTGG
GAGGTACATTT -> AGGTACATTTC
ATTCACGCAGA -> TTCACGCAGAC
AGCGTATTCTG -> GCGTATTCTGT
GATCGTACGTA -> ATCGTACGTAG
ACTGTGGACCA -> CTGTGGACCAA
ACATAGGATTG -> CATAGGATTGA
TATATATTTTC -> ATATATTTTCG
ACTCTCTCCCT -> CTCTCTCCCTA
TTTGAGAGACG -> TTGAGAGACGG
TACTTATTCAT -> ACTTATTCATG
CTTCTCTCTTG -> TTCTCTCTTGA
CTCACGTCACT -> TCACGTCACTA
GATAGTAGAAC -> ATAGTAGAACG
ATTTTCGCTCC -> TTTTCGCTCCC
CGTCACTAATG -> GTCACTAATGC
TGGAAAAATCT -> GGAAAAATCTG
GCGATTTGTTC -> CGATTTGTTCC
CGGTACAAATA -> GGTACAAATAG
ATGGCGCGCCC -> TGGCGCGCCCC
TGCCTGCTTCT -> GCCTGCTTCTT
TATAGTCAGAT -> ATAGTCAGATG
TGTGAACCGTG -> GTGAACCGTGA
GTAGCCGGGGT -> TAGCCGGGGTA
ACTGCCTTTGT -> CTGCCTTTGTC
TGTACGGCGCA -> GTACGGCGCAT
TCGCTCCCGCC -> CGCTCCCGCCA
GACTCTGGTCA -> ACTCTGGTCAA
CGGGCGTCACC -> GGGCGTCACCT
GTCCTCATCCC -> TCCTCATCCCA
GATTTGTTCCG -> ATTTGTTCCGA
ACCGTCCTGTA -> CCGTCCTGTAG
GGGCTGAATCG -> GGCTGAATCGA
TGTAGGGCTGA -> GTAGGGCTGAA
TGCGAGCTAGG -> GCGAGCTAGGC
AAGCGTATTCT -> AGCGTATTCTG
GGCACTGTTAT -> GCACTGTTATT
GAGATCTCACG -> AGATCTCACGA
CTGTGATCCAC -> TGTGATCCACC
AGGCTATAGTC -> GGCTATAGTCA
CGTCCTGTAGG -> GTCCTGTAGGG
TTCGCATTGGC -> TCGCATTGGCC
GACCCCTTCAT -> ACCCCTTCATG
CTTATTACCCG -> TTATTACCCGC
CCTTCCTGACG -> CTTCCTGACGC
CCCCACAGCTA -> CCCACAGCTAC
TGCTTCTTCGC -> GCTTCTTCGCT
CGCTTAGTAAC -> GCTTAGTAACA
ACGGATCGTAC -> CGGATCGTACG
ATTTTTAAACG -> TTTTTAAACGT
AATGGCGCGCC -> ATGGCGCGCCC
TTCGACCCCGG -> TCGACCCCGGA
TTGCTGTCTTA -> TGCTGTCTTAT
TTCGGCGCGCT -> TCGGCGCGCTT
TATGACATGGA -> ATGACATGGAA
CTATACGTACC -> TATACGTACCA
AAATCTGCTGG -> AATCTGCTGGT
TTACGCCGTCG -> TACGCCGTCGG
GTCTGTTCGGC -> TCTGTTCGGCG
TAGGCAAAGGG -> AGGCAAAGGGA
CGCGAAAACGG -> GCGAAAACGGG
TTCATTACACT -> TCATTACACTC
GCGCTTAGTAA -> CGCTTAGTAAC
CCTTGTGTCCT -> CTTGTGTCCTT
ATATTGTGCCT -> TATTGTGCCTG
CACGCACTGGA -> ACGCACTGGAC
GTCGAGCTATA -> TCGAGCTATAC
GTTGCTGTCTT -> TTGCTGTCTTA
TTTGGAATTTT -> TTGGAATTTTG
ACCAAAAAGAC -> CCAAAAAGACT
GGACAATGGCA -> GACAATGGCAG
CTGCCTTTGTC -> TGCCTTTGTCA
TCATATTTGAG -> CATATTTGAGA
GCGTAACGGAT -> CGTAACGGATC
GTTATGACATG -> TTATGACATGG
GTACATTTCGT -> TACATTTCGTC
CATTCGCCTTG -> ATTCGCCTTGT
CCACCCTTTTA -> CACCCTTTTAT
CCGAGATAGTA -> CGAGATAGTAG
GCATGTTAAAC -> CATGTTAAACA
AAACTCCAACC -> AACTCCAACCA
TGGCGCCAAGT -> GGCGCCAAGTT
AGGAACATAGG -> GGAACATAGGC
TGCCCTAGGCT -> GCCCTAGGCTG
CGGGAGCTAGA -> GGGAGCTAGAA
CATAGGACATA -> ATAGGACATAC
AAGACTCGGTT -> AGACTCGGTTA
ATGGCTCCCCC -> TGGCTCCCCCA
GTAGTGCTTAT -> TAGTGCTTATC
TTCTGTCGGGA -> TCTGTCGGGAT
ATGGCAGGAGA -> TGGCAGGAGAT
TTTTCGCTCCC -> TTTCGCTCCCG
AAGTATACTTA -> AGTATACTTAT
ACGTAGGCTGC -> CGTAGGCTGCC
AGCTAGAATTT -> GCTAGAATTTC
AGGTACATTTC -> GGTACATTTCG
GAGACTCCACA -> AGACTCCACAT
TGGACTATATA -> GGACTATATAT
TCGATCAGCCA -> CGATCAGCCAT
AGGAGATCTCA -> GGAGATCTCAC
ATCGGCCCATG -> TCGGCCCATGG
CCTGGCGTTTT -> CTGGCGTTTTC
GCGGTAGCCGG -> CGGTAGCCGGG
GCTAAACCATT -> CTAAACCATTG
CTGTAGCGGAA -> TGTAGCGGAAA
AATCGGAAGCG -> ATCGGAAGCGT
GACTGAAGGAG -> ACTGAAGGAGA
GAGGACTTTTT -> AGGACTTTTTC
GCTTATCTGGA -> CTTATCTGGAT
AAAAATCTGCT -> AAAATCTGCTG
GCAATGGAAAA -> CAATGGAAAAA
CATCAACATAG -> ATCAACATAGG
CAAAAAGACTC -> AAAAAGACTCG
TTTTCACCATT -> TTTCACCATTG
CGGGGTATCCT -> GGGGTATCCTG
GGGAGCTAGAA -> GGAGCTAGAAT
CCTAGTCCTCA -> CTAGTCCTCAT
AAATAACCTCC -> AATAACCTCCA
TACGTAGGCTG -> ACGTAGGCTGC
AGATTAAGTAT -> GATTAAGTATA
GCCGTTGCTGT -> CCGTTGCTGTC
GACGCACTCTC -> ACGCACTCTCA
TGTTATTGTAA -> GTTATTGTAAG
CGACCACTCCG -> GACCACTCCGG