TGAGCACTCCC -> GAGCACTCCCA
CGCATCGGCGA -> GCATCGGCGAG
CTCCGACAACA -> TCCGACAACAA
GTGCAGTTCGT -> TGCAGTTCGTG
TCGAAGTCTGA -> CGAAGTCTGAC
CTGAGTGCAAG -> TGAGTGCAAGA
TGTACGCTACT -> GTACGCTACTC
TCGTTCCTGTC -> CGTTCCTGTCT
AAGAACCGTGC -> AGAACCGTGCG
CCACCGATGTA -> CACCGATGTAC
GTATTTGTTAC -> TATTTGTTACC
TAGTCCTTGTC -> AGTCCTTGTCA
CGGCCTGAACC -> GGCCTGAACCG
TGGTTGTGACA -> GGTTGTGACAT
CCGCTCTTTGA -> CGCTCTTTGAA
TTGAGCGGCTA -> TGAGCGGCTAA
TACACTTAAAC -> ACACTTAAACA
GGGTATTCTAA -> GGTATTCTAAC
CTCCATCGTAT -> TCCATCGTATG
GTCCTGACCGA -> TCCTGACCGAT
GTATTCCGCAG -> TATTCCGCAGA
CAACTTTGGGG -> AACTTTGGGGA
GTTTAACACGT -> TTTAACACGTC
GATCCCTAATT -> ATCCCTAATTG
ATGGTTGTGAC -> TGGTTGTGACA
CCGTCCTATGC -> CGTCCTATGCC
GGCGCCCGTAT -> GCGCCCGTATA
CATCGTATGGA -> ATCGTATGGAT
GAAACCAGTAA -> AAACCAGTAAT
CGTCCTGACCG -> GTCCTGACCGA
AAGGTACGATG -> AGGTACGATGT
AGATGTAATAA -> GATGTAATAAT
AATAACCGACG -> ATAACCGACGT
TAAATCATCGA -> AAATCATCGAT
AGAATCGTTAC -> GAATCGTTACC
AGCAGCAATGT -> GCAGCAATGTT
AGCCTTGGAAC -> GCCTTGGAACG
TGTAGGTTATG -> GTAGGTTATGC
GATTAGGTTCT -> ATTAGGTTCTC
CGGGACACCCC -> GGGACACCCCT
GTCATTAATAG -> TCATTAATAGT
AACCATCAAAC -> ACCATCAAACC
CAGCACTAAAC -> AGCACTAAACG
TTGGACCAGAC -> TGGACCAGACC
CTTGTATGGGT -> TTGTATGGGTG
TCAGCACTAAA -> CAGCACTAAAC
ACGATGTGGCG -> CGATGTGGCGC
CACGACCTAAG -> ACGACCTAAGC
TCTGTACTAAG -> CTGTACTAAGA
ACGTCCTACTA -> CGTCCTACTAT
AGCGGGTGTCC -> GCGGGTGTCCA
CGCACCTACTG -> GCACCTACTGG
GACAACAAAAA -> ACAACAAAAAG
AGAAACAACTT -> GAAACAACTTT
GGGTGTGCCCT -> GGTGTGCCCTA
TGTGCAGCACG -> GTGCAGCACGG
CATTGTTCTAA -> ATTGTTCTAAG
CTTCTATACCC -> TTCTATACCCT
AATCCAGAATC -> ATCCAGAATCG
TGGCGCCCGTA -> GGCGCCCGTAT
CCTATGCCAGG -> CTATGCCAGGA
ACTTCTATACC -> CTTCTATACCC
AGGTTTATGCC -> GGTTTATGCCT
AGGTACAACCA -> GGTACAACCAC
ACCACACGGAA -> CCACACGGAAC
GGAGTCAAAGC -> GAGTCAAAGCA
CCACCAACCTG -> CACCAACCTGC
GGTCGGTACCT -> GTCGGTACCTG
GATTATTTTGG -> ATTATTTTGGG
ACGTTACCTGG -> CGTTACCTGGT
TGTGCCCTAGA -> GTGCCCTAGAG
ATTGCCTATGG -> TTGCCTATGGC
AGTATGGTGTC -> GTATGGTGTCA
CTAGCAGAACT -> TAGCAGAACTC
TTACCATCTTG -> TACCATCTTGA
GTCTGGGTCGA -> TCTGGGTCGAA
ATCTCGCCCGT -> TCTCGCCCGTG
CCTGACCGATG -> CTGACCGATGC
GGGTAGTGTGC -> GGTAGTGTGCA
GTCGTATCAGT -> TCGTATCAGTT
GAACGGATACA -> AACGGATACAA
TTTGAGACGGC -> TTGAGACGGCC
TAGTGCGAAAG -> AGTGCGAAAGT
TGGACCAGACC -> GGACCAGACCT
TCTGGGTCGAA -> CTGGGTCGAAG
CCGATGGAACG -> CGATGGAACGC
TTAAATCTACC -> TAAATCTACCA
AAATCCAGAAT -> AATCCAGAATC
GTATCTCGAGA -> TATCTCGAGAG
CCAGTAATGGG -> CAGTAATGGGT
AGACTTCTATA -> GACTTCTATAC
TCATAAATGCT -> CATAAATGCTA
CGGCTAAGTGG -> GGCTAAGTGGC
TCTCGAGAGTC -> CTCGAGAGTCA
GACAGTTCCAC -> ACAGTTCCACC
CTTAACAGCCT -> TTAACAGCCTC
GCGGGACACCC -> CGGGACACCCC
GCTAGCAGAAC -> CTAGCAGAACT
TCGACCTGTGG -> CGACCTGTGGA
TTCTATACCCT -> TCTATACCCTA
GGACGTCCTAC -> GACGTCCTACT
TGTAATAATGG -> GTAATAATGGC
CTAGAGGTACA -> TAGAGGTACAA
CCGGGTTTCCA -> CGGGTTTCCAC
CCTTGTCATTG -> CTTGTCATTGT
GCATACCACGA -> CATACCACGAC
ATTTTGGGACG -> TTTTGGGACGA
CTAAGTGGCAG -> TAAGTGGCAGT
TTTGAATGTAC -> TTGAATGTACA
GCCCCTACGCA -> CCCCTACGCAG
ATTAGGTTCTC -> TTAGGTTCTCA
ATTATATCGAC -> TTATATCGACC
CGGCGAGCATA -> GGCGAGCATAC
GCCGTCCTATG -> CCGTCCTATGC
GACGTTACCTG -> ACGTTACCTGG
ATTCTCCATGG -> TTCTCCATGGT
TACACTGCCTT -> ACACTGCCTTG
GTTCCTGTCTG -> TTCCTGTCTGG
CCATGGTGCTC -> CATGGTGCTCA
CCGGTCCCCCG -> CGGTCCCCCGG
CAGCTGGTCTT -> AGCTGGTCTTT
CGCCTAACTTA -> GCCTAACTTAA
GTACAGGGGAG -> TACAGGGGAGT
AGTGACGAGGC -> GTGACGAGGCC
ATCGTATGGAT -> TCGTATGGATT
TGTGGACGTCC -> GTGGACGTCCT
CAGAATCGTTA -> AGAATCGTTAC
GAATGTATTAG -> AATGTATTAGA
TTGAAGGTGGC -> TGAAGGTGGCT
AAGCAGGGAAA -> AGCAGGGAAAA
AAATCTACCAT -> AATCTACCATT
CGCATGCTGGC -> GCATGCTGGCG
CAGGGAATGCC -> AGGGAATGCCC
GCCGCTCTTTG -> CCGCTCTTTGA
GCAATGCGATT -> CAATGCGATTT
TAATGGGTAGT -> AATGGGTAGTG
TAGTAAGGCCA -> AGTAAGGCCAA
AAAAGCCGTCC -> AAAGCCGTCCT
GTAGTCCTTGT -> TAGTCCTTGTC
CGACCTAAGCC -> GACCTAAGCCC
CCTTACCGATG -> CTTACCGATGG
GGTTCTCAGCT -> GTTCTCAGCTG
TAAGAAGCTAA -> AAGAAGCTAAA
GTAGCTGACTA -> TAGCTGACTAG
ACAACCATCAA -> CAACCATCAAA
AACCGGGTTTC -> ACCGGGTTTCC
GATGTACCTAC -> ATGTACCTACT
TATACACTTAA -> ATACACTTAAA
TGACATTGTGA -> GACATTGTGAG
CCTACTGGTTT -> CTACTGGTTTA
CAGCGGCCTCA -> AGCGGCCTCAA
CCTGGCCTGGC -> CTGGCCTGGCA
TGGGTTCTCTT -> GGGTTCTCTTG
TCGAGAGTCAC -> CGAGAGTCACC
CTCTGATGCCT -> TCTGATGCCTT
CGAGGCCGCAT -> GAGGCCGCATG
AATGCTATGTC -> ATGCTATGTCG
AGTGGGTGATC -> GTGGGTGATCA
TTATTGCCTAT -> TATTGCCTATG
ATGCCCACCGA -> TGCCCACCGAT
AGCTAAATCAT -> GCTAAATCATC
CGACATGAATT -> GACATGAATTT
TATGTCGTCGA -> ATGTCGTCGAC
GCCCACCGATG -> CCCACCGATGT
GCAATGTTTTT -> CAATGTTTTTC
TTATAGCCTCA -> TATAGCCTCAC
TGTTACCATCT -> GTTACCATCTT
CCCTAATTGTC -> CCTAATTGTCG
ACGGATACAAC -> CGGATACAACC
CAGCAATGTTT -> AGCAATGTTTT
GTTCTCTTGTC -> TTCTCTTGTCT
TCCCCCGGGAG -> CCCCCGGGAGG
TGTCCAGGCCG -> GTCCAGGCCGC
ATGACGTAGCT -> TGACGTAGCTG
TACTAGTGCGA -> ACTAGTGCGAA
TGGACGTCCTA -> GGACGTCCTAC
CTTGCAGGGTT -> TTGCAGGGTTG
ACGACTCTTAT -> CGACTCTTATA
CATGACGTAGC -> ATGACGTAGCT
TAATTCATGGC -> AATTCATGGCG
ATCTTGAGCGG -> TCTTGAGCGGC
CGATTCTCCAT -> GATTCTCCATG
CAGAGCTTGAG -> AGAGCTTGAGA
CTCATAAATGC -> TCATAAATGCT
CACTCAGCACT -> ACTCAGCACTA
ACCTACTGAGT -> CCTACTGAGTA
GCCTGATGTCA -> CCTGATGTCAG
TGGTCTTTGTA -> GGTCTTTGTAG
TTTTGGGACGA -> TTTGGGACGAC
AGACTAACTGA -> GACTAACTGAG
GCTTGAGATAC -> CTTGAGATACA
CAGTTCCACCT -> AGTTCCACCTC
GGAAGTAATTC -> GAAGTAATTCA
GGCGCGTCCTG -> GCGCGTCCTGT
GGCTGGAGAAA -> GCTGGAGAAAC
CTGGAGAAACA -> TGGAGAAACAA
TCTACCATTTT -> CTACCATTTTG
GTGTAGACAAC -> TGTAGACAACA
TACAACCATCA -> ACAACCATCAA
ATCCAGAATCG -> TCCAGAATCGT
TGCTACGTAGT -> GCTACGTAGTG
AAGGTGGCTTG -> AGGTGGCTTGC
AGTGTCGTATC -> GTGTCGTATCA
GACTCTGATGC -> ACTCTGATGCC
GAGTTGTCGTT -> AGTTGTCGTTT
CGGAGTCAAAG -> GGAGTCAAAGC
TGGAACGCTTT -> GGAACGCTTTC
CGTACTACCTA -> GTACTACCTAT
TGGGTAGTGTG -> GGGTAGTGTGC
ACCTGGTATTC -> CCTGGTATTCC
TGGCGGGGTAT -> GGCGGGGTATT
ACAAAAAGCCG -> CAAAAAGCCGT
TGCGGGACACC -> GCGGGACACCC
GAAGCTAAATC -> AAGCTAAATCA
TCGTTTAAATG -> CGTTTAAATGA
CCGTCCTGACC -> CGTCCTGACCG
TCTGGCTTAAA -> CTGGCTTAAAT
TCACGAAAGCG -> CACGAAAGCGG
GCCTCAATGAT -> CCTCAATGATT
CCCGGGAGGCA -> CCGGGAGGCAG
AGTGTGCAGCA -> GTGTGCAGCAC
GTTCTAAGGCA -> TTCTAAGGCAA
CGCTTTCGGAG -> GCTTTCGGAGT
GAGGCCTGATG -> AGGCCTGATGT
TACTGGTTTAA -> ACTGGTTTAAC
CGCTCGTTCCT -> GCTCGTTCCTG
ACACTGCCTTG -> CACTGCCTTGT
TCGACAGTTCC -> CGACAGTTCCA
CTTGTCTGCCC -> TTGTCTGCCCG
GTCCAGGCCGC -> TCCAGGCCGCT
CGCTTATTATA -> GCTTATTATAT
GGCGAGCATAC -> GCGAGCATACA
TCGGAAGTAAT -> CGGAAGTAATT
AATGAGCACTC -> ATGAGCACTCC
GCCTATGGCTG -> CCTATGGCTGG
ACTAGTGCGAA -> CTAGTGCGAAA
GAGACGGACAC -> AGACGGACACG
TCTTGTCTGCC -> CTTGTCTGCCC
TCATTAATAGT -> CATTAATAGTA
CTGGTATTCCG -> TGGTATTCCGC
CCCGTAGTTCC -> CCGTAGTTCCG
GGACTCTGATG -> GACTCTGATGC
TGGAGTATTTG -> GGAGTATTTGT
CGCAAGCTTAA -> GCAAGCTTAAT
TATACGATCTC -> ATACGATCTCG
TGACGTAGCTG -> GACGTAGCTGA
ATAAAGGCTCC -> TAAAGGCTCCG
GTAGTGTCGTA -> TAGTGTCGTAT
TTTCCACCTAC -> TTCCACCTACG
GCTGACGAATG -> CTGACGAATGT
CCATGAATAAC -> CATGAATAACC
TGTACCTACTG -> GTACCTACTGA
TACGCTGACGA -> ACGCTGACGAA
CGGCTTGGGTT -> GGCTTGGGTTC
AGAGCTTGAGA -> GAGCTTGAGAT
TGAGACGGACA -> GAGACGGACAC
GCTGACTAGGA -> CTGACTAGGAC
CCGCAAAATCC -> CGCAAAATCCA
CATAAAGGCTC -> ATAAAGGCTCC
CTAATTGTCGT -> TAATTGTCGTC
GGGAGGCAGGA -> GGAGGCAGGAG
TAGAGGTACAA -> AGAGGTACAAC
CAGCCTCCGAC -> AGCCTCCGACA
CCGCCTAACTT -> CGCCTAACTTA
CTACTGAGTAT -> TACTGAGTATG
AAGACTTCTAT -> AGACTTCTATA
TGGATTCACAT -> GGATTCACATC
CCTAAGCCCAC -> CTAAGCCCACA
ACGATTACGCG -> CGATTACGCGC
CCCACCAACCT -> CCACCAACCTG
GCCGCATGCTG -> CCGCATGCTGG
TACCATTTTGA -> ACCATTTTGAT
CCGGAAGCTGC -> CGGAAGCTGCG
GCACTAAACGT -> CACTAAACGTA
CCACACGGAAC -> CACACGGAACG
CATCAAACCGG -> ATCAAACCGGT
CGAAAGCGGGT -> GAAAGCGGGTG
CTTGAGCGGCT -> TTGAGCGGCTA
GCGAGCATACA -> CGAGCATACAC
AAACAGGTTTA -> AACAGGTTTAT
GGTATTCCGCA -> GTATTCCGCAG
CATGGTGCTCA -> ATGGTGCTCAT
GACCGTCCTGA -> ACCGTCCTGAG
CTACGCAGCCT -> TACGCAGCCTT
GCATACACTGC -> CATACACTGCC
CGTTCGAGCCA -> GTTCGAGCCAT
GGGTGTCCAGG -> GGTGTCCAGGC
GAAGTAATTCA -> AAGTAATTCAT
GTCAAGCCGTA -> TCAAGCCGTAC
GACGACAATCT -> ACGACAATCTG
AGATTAGGCCA -> GATTAGGCCAC
TTCTCCATGGT -> TCTCCATGGTG
TTTAACACGTC -> TTAACACGTCG
AATGGCTGCGT -> ATGGCTGCGTA
AACAGCCTCCG -> ACAGCCTCCGA
CCTTTATTGCC -> CTTTATTGCCT
GCCCGTGTAAG -> CCCGTGTAAGA
CACCCTTTATT -> ACCCTTTATTG
TACACGGTGAG -> ACACGGTGAGA
ACGTACCTCTG -> CGTACCTCTGG
TGTATGGGTGT -> GTATGGGTGTG
CGTGCATCACG -> GTGCATCACGC
TCAGTTGACGA -> CAGTTGACGAC
CCGACAACAAA -> CGACAACAAAA
TGTGGCCCCTA -> GTGGCCCCTAC
GAATAACCGAC -> AATAACCGACG
CGTGGTTTTTT -> GTGGTTTTTTA
CCGTGGTTTTT -> CGTGGTTTTTT
AGGTAGTGTCG -> GGTAGTGTCGT
GCAGGAGATAC -> CAGGAGATACT
TTGTATGGGTG -> TGTATGGGTGT
TCTTTGAAACC -> CTTTGAAACCA
GGGGACCGTCC -> GGGACCGTCCT
CGTTACCTGGT -> GTTACCTGGTA
CAGTAATGGGT -> AGTAATGGGTA
GGGTGATCACA -> GGTGATCACAC
GTCGACAGTTC -> TCGACAGTTCC
AACCGTGCGTA -> ACCGTGCGTAA
TGATGTCAGGG -> GATGTCAGGGA
GAGGCAGGAGA -> AGGCAGGAGAT
CCTACTGAGTA -> CTACTGAGTAT
CGGGAGGCAGG -> GGGAGGCAGGA
AAGCAGCAATG -> AGCAGCAATGT
AAGCTTAATAT -> AGCTTAATATA
CGTCTAAGTGA -> GTCTAAGTGAC
AACCTGCGTTC -> ACCTGCGTTCG
GGGGTATTCTA -> GGGTATTCTAA
CCTGGAAGCAG -> CTGGAAGCAGC
TCACCCGTCCT -> CACCCGTCCTG
TACACGATTAC -> ACACGATTACG
GGTAGTGTCGT -> GTAGTGTCGTA
ATGTTACACGG -> TGTTACACGGT
CCACTCAGCAC -> CACTCAGCACT
GAGGCCGCATG -> AGGCCGCATGC
TTGTTACCATC -> TGTTACCATCT
TTAGACCCAGA -> TAGACCCAGAC
TACTGAGTGCA -> ACTGAGTGCAA
AGGCTCCGCTC -> GGCTCCGCTCG
TTCGAGGCCTG -> TCGAGGCCTGA
CTAACTATGTG -> TAACTATGTGG
ACGGATTCCTA -> CGGATTCCTAG
CTTATTATATC -> TTATTATATCG
TACCGATGGAA -> ACCGATGGAAC
ACCTACTGGTT -> CCTACTGGTTT
AACCCTCCCGA -> ACCCTCCCGAT
GTTGACGACAA -> TTGACGACAAG
TAGTTCCGACA -> AGTTCCGACAT
TGTGGAGTATT -> GTGGAGTATTT
GCTTGCAGGGT -> CTTGCAGGGTT
GATACCTGGCC -> ATACCTGGCCT
GTTGTGACATT -> TTGTGACATTG
GTTGTCGTTTA -> TTGTCGTTTAA
CCACCCTTTAT -> CACCCTTTATT
GTGCATCACGC -> TGCATCACGCT
TCCGGAAGCTG -> CCGGAAGCTGC
GATGCCCCATA -> ATGCCCCATAC
CGTCCTATGCC -> GTCCTATGCCA
CTTAATATACG -> TTAATATACGA
ATCGATTGTAC -> TCGATTGTACG
TTCTTGTATGG -> TCTTGTATGGG
ATTAGACCCAG -> TTAGACCCAGA
GAGACGGCCTG -> AGACGGCCTGA
GCCTATTACGC -> CCTATTACGCT
CCGTACTACCT -> CGTACTACCTA
GACTAACTGAG -> ACTAACTGAGT
AACTTAACAGC -> ACTTAACAGCC
TAAGTGACACG -> AAGTGACACGT
CTAAGAACCGT -> TAAGAACCGTG
CATTCAAAGGC -> ATTCAAAGGCC
GGACACGATTA -> GACACGATTAG
ATCAGTTGACG -> TCAGTTGACGA
ACGATCTCGCC -> CGATCTCGCCC
TCAAGCCGTAC -> CAAGCCGTACT
ACAGCGGCCTC -> CAGCGGCCTCA
TTCCGACATGA -> TCCGACATGAA
TATGTGGCCCC -> ATGTGGCCCCT
CAGGATGATAC -> AGGATGATACC
TGGGTGATCAC -> GGGTGATCACA
AGCAGAACTCC -> GCAGAACTCCG
GGATTCCTAGT -> GATTCCTAGTC
TGTACTAAGAA -> GTACTAAGAAC
GGTAGTGTGCA -> GTAGTGTGCAG
GAATCGTTACC -> AATCGTTACCG
ACTATGTGGCC -> CTATGTGGCCC
CTGTAGTCCTT -> TGTAGTCCTTG
ACAGCCTCCGA -> CAGCCTCCGAC
CAACAGCGGCC -> AACAGCGGCCT
TGGCGCTTATT -> GGCGCTTATTA
ACGGAACGGAT -> CGGAACGGATA
TGATACCTGGC -> GATACCTGGCC
TCTGCCCGTAG -> CTGCCCGTAGT
TAACTATGTGG -> AACTATGTGGC
CACTGCCTTGT -> ACTGCCTTGTG
ATCACACCGCC -> TCACACCGCCT
GCGTTCGAGCC -> CGTTCGAGCCA
TAGTGTGCAGC -> AGTGTGCAGCA
TGAGTTGTCGT -> GAGTTGTCGTT
CCTACTATGGT -> CTACTATGGTT
CATGAATTTGA -> ATGAATTTGAG
TCGGGGAATCT -> CGGGGAATCTT
GATTTCTACTG -> ATTTCTACTGA
CAACAAAAAGC -> AACAAAAAGCC
AGAACCGTGCG -> GAACCGTGCGT
GTACTAAGAAC -> TACTAAGAACC
TGTAGTCCTTG -> GTAGTCCTTGT
GTTTATGCCTC -> TTTATGCCTCC
TGGTGCTCATA -> GGTGCTCATAA
CGGTACCTGGA -> GGTACCTGGAA
TATTCTTGTAT -> ATTCTTGTATG
AGAGTCACCCG -> GAGTCACCCGT
CGAGCATACAC -> GAGCATACACT
ATTATTTTGGG -> TTATTTTGGGA
TATGGCTGGAG -> ATGGCTGGAGA
AGCCGTACTAC -> GCCGTACTACC
GTCCTTGTCAT -> TCCTTGTCATT
CGAGGCCTGAT -> GAGGCCTGATG
TACAGGGGAGT -> ACAGGGGAGTA
AGTGGCCTATT -> GTGGCCTATTA
ATTTGAGACGG -> TTTGAGACGGC
TCGATTGTACG -> CGATTGTACGC
GTTTAAATGAG -> TTTAAATGAGC
ACCCCTACCAC -> CCCCTACCACT
CTTAAATCTAC -> TTAAATCTACC
GTATGGATTCA -> TATGGATTCAC
GCGCCGCAAAA -> CGCCGCAAAAT
CCTTGGAACGC -> CTTGGAACGCT
GCGGCTAAGTG -> CGGCTAAGTGG
GACTCTTATAG -> ACTCTTATAGC
ATCGGCGAGCA -> TCGGCGAGCAT
GGCAGGAGATA -> GCAGGAGATAC
TGGCTGGAGAA -> GGCTGGAGAAA
AGAACTCCGCT -> GAACTCCGCTA
ACACGTGCTAG -> CACGTGCTAGC
GTTCCACCTCT -> TTCCACCTCTG
TTCGTGCTACG -> TCGTGCTACGT
GAGTTCGCATC -> AGTTCGCATCG
TTTTATCTCGG -> TTTATCTCGGG
TCCCACCAACC -> CCCACCAACCT
GGCTCCGCTCG -> GCTCCGCTCGT
AAAGGCTCCGC -> AAGGCTCCGCT
AGTCATTAATA -> GTCATTAATAG
CTTTGAAACCA -> TTTGAAACCAG
GCAGCCTTGGA -> CAGCCTTGGAA
ATGGTGTCAAG -> TGGTGTCAAGC
TTCGAGCCATG -> TCGAGCCATGA
TATGGTGTCAA -> ATGGTGTCAAG
CGGATTCCTAG -> GGATTCCTAGT
CAGCTGGCATA -> AGCTGGCATAC
GAGTATTTGTT -> AGTATTTGTTA
CTACCTATACG -> TACCTATACGA
ATGGCTGCGTA -> TGGCTGCGTAT
CGATGGAACGC -> GATGGAACGCA
AATAATGGCTG -> ATAATGGCTGC
AAACGTACCTC -> AACGTACCTCT
GTGGACGTCCT -> TGGACGTCCTA
TGCCCTAGAGG -> GCCCTAGAGGT
AGTAATGGGTA -> GTAATGGGTAG
CTCCGGAAGCT -> TCCGGAAGCTG
ACTAAACGTAC -> CTAAACGTACC
TGTCTGGGTCG -> GTCTGGGTCGA
CGTAGTTCCGA -> GTAGTTCCGAC
GATGTAATAAT -> ATGTAATAATG
CCCCCGGGAGG -> CCCCGGGAGGC
CATACCACGAC -> ATACCACGACC
CCGTAGTTCCG -> CGTAGTTCCGA
GCGTCCTGTCT -> CGTCCTGTCTC
AAACCGGTCCC -> AACCGGTCCCC
GCTATGTCGTC -> CTATGTCGTCG
GTTTTTTATCT -> TTTTTTATCTC
ATGTACCTACT -> TGTACCTACTG
GTTGAAGGTGG -> TTGAAGGTGGC
GGCCTATTACG -> GCCTATTACGC
AAGGCCAACAG -> AGGCCAACAGC
GGTGATCACAC -> GTGATCACACC
GGGACACCCCT -> GGACACCCCTA
ATTGTGAGATG -> TTGTGAGATGT
GGTTTTTTATC -> GTTTTTTATCT
CTGCGTGTGGA -> TGCGTGTGGAC
TATGGATTCAC -> ATGGATTCACA
ACTGAGTTGTC -> CTGAGTTGTCG
CCTGTCTCGGA -> CTGTCTCGGAA
AGACCTCCCGA -> GACCTCCCGAC
TATGGTTGTGA -> ATGGTTGTGAC
GAAAACGGTTA -> AAAACGGTTAA
CCCGTGTAAGA -> CCGTGTAAGAA
TTGTGACATTG -> TGTGACATTGT
AATAGTAAGGC -> ATAGTAAGGCC
ATGTACAGGGG -> TGTACAGGGGA
ACAACATAAAG -> CAACATAAAGG
ACAACTTTGGG -> CAACTTTGGGG
AACTATGTGGC -> ACTATGTGGCC
AGCCTCCGACA -> GCCTCCGACAA
TCTAAGGCAAA -> CTAAGGCAAAT
CCGATGCCCCA -> CGATGCCCCAT
CCTGATGTCAG -> CTGATGTCAGG
ATATACGATTA -> TATACGATTAG
ACCGATGGAAC -> CCGATGGAACG
TAAACGTACCT -> AAACGTACCTC
AGTTCCACCTC -> GTTCCACCTCT
TCAGCTGGCAT -> CAGCTGGCATA
TAGATTAGGCC -> AGATTAGGCCA
AGGCAGGAGAT -> GGCAGGAGATA
CCTCTGTACTA -> CTCTGTACTAA
GGATTCACATC -> GATTCACATCG
TGGGTCGAAGT -> GGGTCGAAGTC
TATCTCGAGAG -> ATCTCGAGAGT
TACCACGACCT -> ACCACGACCTA
GCCTTACCGAT -> CCTTACCGATG
TTAAACAGGTT -> TAAACAGGTTT
GAAGTCTGACA -> AAGTCTGACAC
CTACCATTTTG -> TACCATTTTGA
CTGGCATACCA -> TGGCATACCAC
CAAAAAGCCGT -> AAAAAGCCGTC
TGGCAGTTGAA -> GGCAGTTGAAG
GTGCGTAAGGT -> TGCGTAAGGTA
AGGGAATGCCC -> GGGAATGCCCA
AGCTTGAGATA -> GCTTGAGATAC
CGACCAGCGTG -> GACCAGCGTGC
GCCTAACTTAA -> CCTAACTTAAC
CTCGGAAGTAA -> TCGGAAGTAAT
ACCCTTTATTG -> CCCTTTATTGC
GGAACGCAAGC -> GAACGCAAGCT
CAGGGAAAACG -> AGGGAAAACGG
CGCGTCCTGTC -> GCGTCCTGTCT
GGGTTTCCACC -> GGTTTCCACCT
GGCCATGAATA -> GCCATGAATAA
GGTGTCAAGCC -> GTGTCAAGCCG
CCCGACCAGCG -> CCGACCAGCGT
ATCTGTAGTCC -> TCTGTAGTCCT
TCATCGATTGT -> CATCGATTGTA
ACGAATGTATT -> CGAATGTATTA
CCATCAAACCG -> CATCAAACCGG
AGTGACACGTG -> GTGACACGTGC
TACCGTGGTTT -> ACCGTGGTTTT
GTGTCAAGCCG -> TGTCAAGCCGT
AAGGCAAATGT -> AGGCAAATGTT
TTTGATCCCTA -> TTGATCCCTAA
CCTCCCGACCA -> CTCCCGACCAG
CAAGCTTAATA -> AAGCTTAATAT
TTTATGCCTCC -> TTATGCCTCCG
ACCTGGAAGCA -> CCTGGAAGCAG
TCCTTGTCATT -> CCTTGTCATTG
TCTTATAGCCT -> CTTATAGCCTC
TGGCCTATTAC -> GGCCTATTACG
TAGTGTCGTAT -> AGTGTCGTATC
GACCTGTGGAG -> ACCTGTGGAGT
ACGGACACGAT -> CGGACACGATT
CTTTCGGAGTC -> TTTCGGAGTCA
TACCACTCAGC -> ACCACTCAGCA
AATGTACAGGG -> ATGTACAGGGG
AATGATTATTT -> ATGATTATTTT
ACACGTCGGTC -> CACGTCGGTCG
CTGCCTTGTGC -> TGCCTTGTGCA
AGCCCACATTC -> GCCCACATTCA
GCGAAAGTATC -> CGAAAGTATCT
CATCACGCTCC -> ATCACGCTCCA
TCTTTGTAGGT -> CTTTGTAGGTT
CGTGCTACGTA -> GTGCTACGTAG
GCTTGGGTTCT -> CTTGGGTTCTC
AGCATACACTG -> GCATACACTGC
CTCTGTACTAA -> TCTGTACTAAG
AGTATCTCGAG -> GTATCTCGAGA
GGGAAAACGGT -> GGAAAACGGTT
TCTCCATGGTG -> CTCCATGGTGC
GTGACACGTGC -> TGACACGTGCT
GACATGAATTT -> ACATGAATTTG
GGAAAACGGTT -> GAAAACGGTTA
TCGTCGACAGT -> CGTCGACAGTT
TTCCTAGTCAT -> TCCTAGTCATT
CGACAAGACTT -> GACAAGACTTC
AACATAAAGGC -> ACATAAAGGCT
ACCGATGTACC -> CCGATGTACCT
AACGTACCTCT -> ACGTACCTCTG
GCCAACAGCGG -> CCAACAGCGGC
TCCTATGCCAG -> CCTATGCCAGG
CGTTTAAATGA -> GTTTAAATGAG
GTCATTGTTCT -> TCATTGTTCTA
GACAATCTGTA -> ACAATCTGTAG
TATCGACCTGT -> ATCGACCTGTG
CGGAAGTAATT -> GGAAGTAATTC
GCCCCATACAC -> CCCCATACACG
ACAACAAAAAG -> CAACAAAAAGC
ATTGTCGTCTA -> TTGTCGTCTAA
GTCACCCGTCC -> TCACCCGTCCT
GAGTGCAAGAG -> AGTGCAAGAGT
GACCCAGACTA -> ACCCAGACTAA
CTGATGTCAGG -> TGATGTCAGGG
GGTACCTGGAA -> GTACCTGGAAG
GAGAGTCACCC -> AGAGTCACCCG
AATTTGAGACG -> ATTTGAGACGG
CTGACTAGGAC -> TGACTAGGACT
TGGTTTTTTAT -> GGTTTTTTATC
TCGCATCGGCG -> CGCATCGGCGA
TTGAGAGCAAT -> TGAGAGCAATG
CTTAAACAGGT -> TTAAACAGGTT
GTGGCTTGCAG -> TGGCTTGCAGG
ATTAATAGTAA -> TTAATAGTAAG
TAATATACGAT -> AATATACGATT
CTCACGAAAGC -> TCACGAAAGCG
TGACCGATGCC -> GACCGATGCCC
GTCTAAGTGAC -> TCTAAGTGACG
CAGAACTCCGC -> AGAACTCCGCT
GTAAGGTACGA -> TAAGGTACGAT
CCCCTACCACT -> CCCTACCACTC
GAGATACTAGT -> AGATACTAGTG
ACCTAGCGCAC -> CCTAGCGCACC
CCTAGCGCACC -> CTAGCGCACCT
CACTCCCACCA -> ACTCCCACCAA
CATAAATGCTA -> ATAAATGCTAT
GGTATTCTAAC -> GTATTCTAACC
CTAACTGAGTT -> TAACTGAGTTG
CACGATTACGC -> ACGATTACGCG
TTACCGATGGA -> TACCGATGGAA
GACCTCCCGAC -> ACCTCCCGACC
CCTACCACTCA -> CTACCACTCAG
CTGAGGTAGTG -> TGAGGTAGTGT
GGGGAATCTTC -> GGGAATCTTCG
GTATGGTGTCA -> TATGGTGTCAA
CAACCATCAAA -> AACCATCAAAC
CGTGTAAGAAG -> GTGTAAGAAGC
ATACCACGACC -> TACCACGACCT
AGTTGACGACA -> GTTGACGACAA
GTACAACCACA -> TACAACCACAC
AAAGCCGTCCT -> AAGCCGTCCTA
GCTGCGTATAT -> CTGCGTATATT
AACTGAGTTGT -> ACTGAGTTGTC
CTCTTATAGCC -> TCTTATAGCCT
CAAAATCCAGA -> AAAATCCAGAA
GTGGCCCCTAC -> TGGCCCCTACG
GTGCCCTAGAG -> TGCCCTAGAGG
GGAACGGATAC -> GAACGGATACA
AATGCCCACCG -> ATGCCCACCGA
GTCAAAGCAGG -> TCAAAGCAGGG
ACGAGGCCGCA -> CGAGGCCGCAT
ACGGTCACGGC -> CGGTCACGGCT
GCGGGGTATTC -> CGGGGTATTCT
GCCTCACGAAA -> CCTCACGAAAG
TGCAGTTCGTG -> GCAGTTCGTGC
CCGTGCGTAAG -> CGTGCGTAAGG
TGATCCCTAAT -> GATCCCTAATT
AAGTGACACGT -> AGTGACACGTG
GGCTTGCAGGG -> GCTTGCAGGGT
ATCGACCTGTG -> TCGACCTGTGG
ATTACGCGCCG -> TTACGCGCCGC
ATGCTGGCGCT -> TGCTGGCGCTT
ATGTAATAATG -> TGTAATAATGG
ATACGATTAGA -> TACGATTAGAT
GTGCTACGTAG -> TGCTACGTAGT
GCACTCCCACC -> CACTCCCACCA
GTGACATTGTG -> TGACATTGTGA
GTGGGTGATCA -> TGGGTGATCAC
TCCACCTACGT -> CCACCTACGTA
CTCCCGATTCT -> TCCCGATTCTC
GTCTCGGAAGT -> TCTCGGAAGTA
AAACAACTTTG -> AACAACTTTGG
CCAGGATGATA -> CAGGATGATAC
GCTAAATCATC -> CTAAATCATCG
TCAAAGCAGGG -> CAAAGCAGGGA
GGGAATCTTCG -> GGAATCTTCGA
GATGCCTTGGA -> ATGCCTTGGAC
TCTCGGGGAAT -> CTCGGGGAATC
TGAAACCAGTA -> GAAACCAGTAA
TACCATCTTGA -> ACCATCTTGAG
GGGAATGCCCA -> GGAATGCCCAC
AAAGCAGGGAA -> AAGCAGGGAAA
TAACCGACGTT -> AACCGACGTTA
TTAATAGTAAG -> TAATAGTAAGG
TCATTGTTCTA -> CATTGTTCTAA
CGTATATTCTT -> GTATATTCTTG
ACTTAAACAGG -> CTTAAACAGGT
AACAGCGGCCT -> ACAGCGGCCTC
GTAAGAAGCTA -> TAAGAAGCTAA
AGGCCACCCTT -> GGCCACCCTTT
ATCTACCATTT -> TCTACCATTTT
GACACCCCTAC -> ACACCCCTACC
GATGTCAGGGA -> ATGTCAGGGAA
TTCCACCTACG -> TCCACCTACGT
TGCGTATATTC -> GCGTATATTCT
GTTACACGGTG -> TTACACGGTGA
TCCTGTCTGGG -> CCTGTCTGGGT
ATTTGTTACCA -> TTTGTTACCAT
CTTTGGGGACC -> TTTGGGGACCG
TAGCAGAACTC -> AGCAGAACTCC
ACTCCGCTAGT -> CTCCGCTAGTG
CGATTACGCGC -> GATTACGCGCC
CTACTGGTTTA -> TACTGGTTTAA
TAAAGGCTCCG -> AAAGGCTCCGC
GTGAGATGTAA -> TGAGATGTAAT
ACTGAGTGCAA -> CTGAGTGCAAG
AGGCAAATGTT -> GGCAAATGTTA
GCTTTCGGAGT -> CTTTCGGAGTC
ACGCTTTCGGA -> CGCTTTCGGAG
CATTAATAGTA -> ATTAATAGTAA
TGATTATTTTG -> GATTATTTTGG
AACAACTTTGG -> ACAACTTTGGG
ACTATGGTTGT -> CTATGGTTGTG
CAAAGCAGGGA -> AAAGCAGGGAA
GACCAGCGTGC -> ACCAGCGTGCA
GCTCCATCGTA -> CTCCATCGTAT
GCCCTAGAGGT -> CCCTAGAGGTA
TTGTCATTGTT -> TGTCATTGTTC
CACGTGCTAGC -> ACGTGCTAGCA
GTATTCTAACC -> TATTCTAACCC
GAACGCAAGCT -> AACGCAAGCTT
GCAAGAGTTCG -> CAAGAGTTCGC
CAGCGTGCATC -> AGCGTGCATCA
ACCTGCGTTCG -> CCTGCGTTCGA
TTCACATCGGC -> TCACATCGGCG
AATGGGTAGTG -> ATGGGTAGTGT
TACGTAGTGGG -> ACGTAGTGGGT
GTACGACTCTT -> TACGACTCTTA
CACGGCTTGGG -> ACGGCTTGGGT
TACGTAGTGGC -> ACGTAGTGGCC
GCGCGTCCTGT -> CGCGTCCTGTC
TCTGACACGGT -> CTGACACGGTC
AGCTGGCATAC -> GCTGGCATACC
CTACTCGCCTT -> TACTCGCCTTA
CAAGAGTTCGC -> AAGAGTTCGCA
CTCTGGCTTAA -> TCTGGCTTAAA
GAGCGGCTAAG -> AGCGGCTAAGT
TACCTATACGA -> ACCTATACGAT
TTCTACTGAGT -> TCTACTGAGTG
CAGCACGGATT -> AGCACGGATTC
TGTAGACAACA -> GTAGACAACAT
GCCATGAATAA -> CCATGAATAAC
TGCGAAAGTAT -> GCGAAAGTATC
GACACGTGCTA -> ACACGTGCTAG
TAAGTGGCAGT -> AAGTGGCAGTT
TTAAGTGACAC -> TAAGTGACACG
TCTCGGAAGTA -> CTCGGAAGTAA
CGTCCTGAGGT -> GTCCTGAGGTA
TCGAGGCCTGA -> CGAGGCCTGAT
CGCTGACGAAT -> GCTGACGAATG
TGGGTGTGCCC -> GGGTGTGCCCT
AAAATCCAGAA -> AAATCCAGAAT
CGTCCTGTCTC -> GTCCTGTCTCG
ACGTAGTGGCC -> CGTAGTGGCCT
GAAAGCGGGTG -> AAAGCGGGTGT
ACTGCCTTGTG -> CTGCCTTGTGC
GGGTTCTCTTG -> GGTTCTCTTGT
ACCAGCGTGCA -> CCAGCGTGCAT
ACCATCAAACC -> CCATCAAACCG
GCACGGATTCC -> CACGGATTCCT
ATCGGCGCGTC -> TCGGCGCGTCC
GTCGTCTAAGT -> TCGTCTAAGTG
CGTGCGTAAGG -> GTGCGTAAGGT
TCGGCGCGTCC -> CGGCGCGTCCT
CTGAACCGGGT -> TGAACCGGGTT
CGGTTAAGTGA -> GGTTAAGTGAC
CACTAAACGTA -> ACTAAACGTAC
AGCACTAAACG -> GCACTAAACGT
TTTGTTACCAT -> TTGTTACCATC
ATCCCTAATTG -> TCCCTAATTGT
TAGGACTCTGA -> AGGACTCTGAT
CTGGTCTTTGT -> TGGTCTTTGTA
TACCTGGTATT -> ACCTGGTATTC
AGGCCTGATGT -> GGCCTGATGTC
ACGTAGCTGAC -> CGTAGCTGACT
AGAGTTCGCAT -> GAGTTCGCATC
CGCTCCATCGT -> GCTCCATCGTA
ATTGTACGCTA -> TTGTACGCTAC
CAGCCTTGGAA -> AGCCTTGGAAC
GGCAGCTGGTC -> GCAGCTGGTCT
GTAATAATGGC -> TAATAATGGCT
TTCCACCTCTG -> TCCACCTCTGT
GGGACCGTCCT -> GGACCGTCCTG
TGCAGGGTTGA -> GCAGGGTTGAG
CTGACACGGTC -> TGACACGGTCA
TCACATCGGCG -> CACATCGGCGC
GTCCTACTATG -> TCCTACTATGG
GACCAGACCTC -> ACCAGACCTCC
TGTGAGATGTA -> GTGAGATGTAA
GGATGATACCT -> GATGATACCTG
GTGCTAGCAGA -> TGCTAGCAGAA
ACAACCTAGCG -> CAACCTAGCGC
CAGTTCGTGCT -> AGTTCGTGCTA
TAACTTAACAG -> AACTTAACAGC
GATTAGGCCAC -> ATTAGGCCACC
TGGTATTCCGC -> GGTATTCCGCA
ACTGAGTATGG -> CTGAGTATGGT
CTTTGTAGGTT -> TTTGTAGGTTA
CCGGGAGGCAG -> CGGGAGGCAGG
GGCCTGGCAGC -> GCCTGGCAGCT
AGTATTTGTTA -> GTATTTGTTAC
ATGCCCCATAC -> TGCCCCATACA
ACGATTAGGTT -> CGATTAGGTTC
GATACAACCAT -> ATACAACCATC
CTAGTGTAGAC -> TAGTGTAGACA
TTGTACGCTAC -> TGTACGCTACT
CCCTACGCAGC -> CCTACGCAGCC
CCCTTTATTGC -> CCTTTATTGCC
GGAAGCAGCAA -> GAAGCAGCAAT
ATACCTGGCCT -> TACCTGGCCTG
TGAGAGCAATG -> GAGAGCAATGC
ACACGGTCACG -> CACGGTCACGG
AGTACGACTCT -> GTACGACTCTT
ACGGTGAGACG -> CGGTGAGACGG
ATCTTCGAGGC -> TCTTCGAGGCC
ACGCGCCGCAA -> CGCGCCGCAAA
TCCTGAGGTAG -> CCTGAGGTAGT
TAGACAACATA -> AGACAACATAA
ACCAGTAATGG -> CCAGTAATGGG
ACCCTCCCGAT -> CCCTCCCGATT
CCAGACCTCCC -> CAGACCTCCCG
ACCGCCTAACT -> CCGCCTAACTT
AGCCGTCCTAT -> GCCGTCCTATG
TAGTGGCCTAT -> AGTGGCCTATT
GCCCACATTCA -> CCCACATTCAA
AGTGTAGACAA -> GTGTAGACAAC
AAGAAGCTAAA -> AGAAGCTAAAT
AAGCGGGTGTC -> AGCGGGTGTCC
TACTACCTATA -> ACTACCTATAC
TCTCAGCTGGC -> CTCAGCTGGCA
TAACACGTCGG -> AACACGTCGGT
AACAAAAAGCC -> ACAAAAAGCCG
TTTTTATCTCG -> TTTTATCTCGG
AGTGCAAGAGT -> GTGCAAGAGTT
CCTATACGATC -> CTATACGATCT
GGCTTAAATCT -> GCTTAAATCTA
ACCGTCCTGAG -> CCGTCCTGAGG
CACTTAAACAG -> ACTTAAACAGG
AGCGGCTAAGT -> GCGGCTAAGTG
TGCGTAAGGTA -> GCGTAAGGTAC
TGAATAACCGA -> GAATAACCGAC
ACGCAAGCTTA -> CGCAAGCTTAA
CCCGATTCTCC -> CCGATTCTCCA
TCAGGGAATGC -> CAGGGAATGCC
CCTAACTTAAC -> CTAACTTAACA
TACGCGCCGCA -> ACGCGCCGCAA
GGTACGATGTG -> GTACGATGTGG
TAGTGTAGACA -> AGTGTAGACAA
TTAACACGTCG -> TAACACGTCGG
GTGCAAGAGTT -> TGCAAGAGTTC
TCACGGCTTGG -> CACGGCTTGGG
TACTAAGAACC -> ACTAAGAACCG
CGCCCGTATAC -> GCCCGTATACA
GTGCGAAAGTA -> TGCGAAAGTAT
AGACAACATAA -> GACAACATAAA
CTATACCCTAA -> TATACCCTAAC
GTTCCGACATG -> TTCCGACATGA
GTCGAAGTCTG -> TCGAAGTCTGA
TACGCTACTCG -> ACGCTACTCGC
GGAATGCCCAC -> GAATGCCCACC
AGAGGTACAAC -> GAGGTACAACC
ACGGCCTGAAC -> CGGCCTGAACC
CCTAGAGGTAC -> CTAGAGGTACA
TCTATACCCTA -> CTATACCCTAA
GTTGAGAGCAA -> TTGAGAGCAAT
AGTCTGACACG -> GTCTGACACGG
CACGATTAGGT -> ACGATTAGGTT
TAGCGCACCTA -> AGCGCACCTAC
TGTCGTTTAAA -> GTCGTTTAAAT
TGACGAATGTA -> GACGAATGTAT
CCGCATGCTGG -> CGCATGCTGGC
AGCTGGTCTTT -> GCTGGTCTTTG
ATAAATGCTAT -> TAAATGCTATG
ATGTGGCCCCT -> TGTGGCCCCTA
TAATAGTAAGG -> AATAGTAAGGC
GCATCACGCTC -> CATCACGCTCC
CCAGGCCGCTC -> CAGGCCGCTCT
GACGAGGCCGC -> ACGAGGCCGCA
TTTGAAACCAG -> TTGAAACCAGT
CACCAACCTGC -> ACCAACCTGCG
GGAACGCTTTC -> GAACGCTTTCG
GACATTGTGAG -> ACATTGTGAGA
TTAACAGCCTC -> TAACAGCCTCC
AGGCCAACAGC -> GGCCAACAGCG
CACGGTCACGG -> ACGGTCACGGC
GTAATGGGTAG -> TAATGGGTAGT
AAGCTAAATCA -> AGCTAAATCAT
TCCCGATTCTC -> CCCGATTCTCC
TACCTACTGAG -> ACCTACTGAGT
TTGTCTGCCCG -> TGTCTGCCCGT
TAAGGTACGAT -> AAGGTACGATG
TGACGACAAGA -> GACGACAAGAC
TCCATCGTATG -> CCATCGTATGG
CTTACCGATGG -> TTACCGATGGA
CGGGTGTCCAG -> GGGTGTCCAGG
GGCCAACAGCG -> GCCAACAGCGG
ACTCGCCTTAC -> CTCGCCTTACC
GAAGGTGGCTT -> AAGGTGGCTTG
GCAAAATCCAG -> CAAAATCCAGA
CGTAGCTGACT -> GTAGCTGACTA
TACGATCTCGC -> ACGATCTCGCC
CAATGTTTTTC -> AATGTTTTTCC
GGTGCTCATAA -> GTGCTCATAAA
AGAAGCTAAAT -> GAAGCTAAATC
CACACCGCCTA -> ACACCGCCTAA
CATACACGATT -> ATACACGATTA
TATGCGGGACA -> ATGCGGGACAC
CCTGGTATTCC -> CTGGTATTCCG
GTCGGTACCTG -> TCGGTACCTGG
AGGGAAAACGG -> GGGAAAACGGT
ACTCCCACCAA -> CTCCCACCAAC
GATGGAACGCA -> ATGGAACGCAA
ACCGATGCCCC -> CCGATGCCCCA
GACTAGGACTC -> ACTAGGACTCT
CACATTCAAAG -> ACATTCAAAGG
TACAACCTAGC -> ACAACCTAGCG
GGGTCGAAGTC -> GGTCGAAGTCT
GCTTAAATCTA -> CTTAAATCTAC
GGTCTTTGTAG -> GTCTTTGTAGG
GAACTCCGCTA -> AACTCCGCTAG
GACCTAAGCCC -> ACCTAAGCCCA
ATAGTAAGGCC -> TAGTAAGGCCA
TGCAAGAGTTC -> GCAAGAGTTCG
GTACCTGGAAG -> TACCTGGAAGC
GTCGGTCGGTA -> TCGGTCGGTAC
CATCTTGAGCG -> ATCTTGAGCGG
TACCTGGCCTG -> ACCTGGCCTGG
GTTATGCGGGA -> TTATGCGGGAC
AACCACACGGA -> ACCACACGGAA
TATTAGACCCA -> ATTAGACCCAG
GGCCTCAATGA -> GCCTCAATGAT
TGCTAGCAGAA -> GCTAGCAGAAC
GAGAAACAACT -> AGAAACAACTT
ATACTAGTGCG -> TACTAGTGCGA
GCGTAAGGTAC -> CGTAAGGTACG
GAGGTACAACC -> AGGTACAACCA
TTTTGATCCCT -> TTTGATCCCTA
GTTAAGTGACA -> TTAAGTGACAC
ACACGATTAGG -> CACGATTAGGT
GTGGCAGTTGA -> TGGCAGTTGAA
GTTACCTGGTA -> TTACCTGGTAT
TCCTGTCTCGG -> CCTGTCTCGGA
AACCTAGCGCA -> ACCTAGCGCAC
TAAGTGACGAG -> AAGTGACGAGG
GTTTCCACCTA -> TTTCCACCTAC
CCACGACCTAA -> CACGACCTAAG
GTTCTCAGCTG -> TTCTCAGCTGG
ATTCATGGCGG -> TTCATGGCGGG
ACATTCAAAGG -> CATTCAAAGGC
CGAGCCATGAC -> GAGCCATGACG
AAAGTATCTCG -> AAGTATCTCGA
TGAACCGGGTT -> GAACCGGGTTT
TAACCCTCCCG -> AACCCTCCCGA
CGGGGAATCTT -> GGGGAATCTTC
ATGCCTTGGAC -> TGCCTTGGACC
TTATATCGACC -> TATATCGACCT
CGAGAGTCACC -> GAGAGTCACCC
CTGAGTTGTCG -> TGAGTTGTCGT
TATTCTAACCC -> ATTCTAACCCT
TTCCGCAGAGC -> TCCGCAGAGCT
CCATCTTGAGC -> CATCTTGAGCG
GATGTGGCGCC -> ATGTGGCGCCC
TTGTCGTTTAA -> TGTCGTTTAAA
TAGTGGGTGAT -> AGTGGGTGATC
TCGGAGTCAAA -> CGGAGTCAAAG
CGAAGTCTGAC -> GAAGTCTGACA
ACGTAGTGGGT -> CGTAGTGGGTG
ACCAACCTGCG -> CCAACCTGCGT
TATATTCTTGT -> ATATTCTTGTA
GGCCGCATGCT -> GCCGCATGCTG
TCTAACCCTCC -> CTAACCCTCCC
TTTATCTCGGG -> TTATCTCGGGG
GAACCGTGCGT -> AACCGTGCGTA
AAGTATCTCGA -> AGTATCTCGAG
TGCTGGCGCTT -> GCTGGCGCTTA
CCTAGTCATTA -> CTAGTCATTAA
GGCAGTTGAAG -> GCAGTTGAAGG
GCCCGTAGTTC -> CCCGTAGTTCC
GGACACCCCTA -> GACACCCCTAC
CGTAGTGGCCT -> GTAGTGGCCTA
GTAATTCATGG -> TAATTCATGGC
TGCCAGGATGA -> GCCAGGATGAT
GTCCCCCGGGA -> TCCCCCGGGAG
AAACCAGTAAT -> AACCAGTAATG
TACGATTAGAT -> ACGATTAGATT
AATCTTCGAGG -> ATCTTCGAGGC
ACCACGACCTA -> CCACGACCTAA
CAGTTGAAGGT -> AGTTGAAGGTG
CCGTGTAAGAA -> CGTGTAAGAAG
GTAAGGCCAAC -> TAAGGCCAACA
CACCTACGTAG -> ACCTACGTAGT
GCCATGACGTA -> CCATGACGTAG
ATGATTATTTT -> TGATTATTTTG
TTTGGGACGAC -> TTGGGACGACA
ACTAGGACTCT -> CTAGGACTCTG
CATCGGCGAGC -> ATCGGCGAGCA
GTACTACCTAT -> TACTACCTATA
GGAGTATTTGT -> GAGTATTTGTT
GGCATACCACG -> GCATACCACGA
TGCCCGTAGTT -> GCCCGTAGTTC
GAATTTGAGAC -> AATTTGAGACG
ACACGGAACGG -> CACGGAACGGA
GGTTAAGTGAC -> GTTAAGTGACA
TAGACCCAGAC -> AGACCCAGACT
TGGCTGCGTAT -> GGCTGCGTATA
AGTGGCAGTTG -> GTGGCAGTTGA
TGTTCTAAGGC -> GTTCTAAGGCA
CGCAGAGCTTG -> GCAGAGCTTGA
TGCTATGTCGT -> GCTATGTCGTC
CGATGTACCTA -> GATGTACCTAC
CAAAGGCCATG -> AAAGGCCATGA
CGTTACCGTGG -> GTTACCGTGGT
ACCTAAGCCCA -> CCTAAGCCCAC
CCTGCGTTCGA -> CTGCGTTCGAG
TCTCTTGTCTG -> CTCTTGTCTGC
AAGGCCATGAA -> AGGCCATGAAT
CTACGTAGTGG -> TACGTAGTGGG,TACGTAGTGGC
GTGGAGTATTT -> TGGAGTATTTG
CGTACCTCTGG -> GTACCTCTGGC
AATCTGTAGTC -> ATCTGTAGTCC
GCAGCACGGAT -> CAGCACGGATT
CATGGCGGGGT -> ATGGCGGGGTA
CGCTACTCGCC -> GCTACTCGCCT
TCGTTACCGTG -> CGTTACCGTGG
TGTCGTCTAAG -> GTCGTCTAAGT
ACCGACGTTAC -> CCGACGTTACC
CATCGATTGTA -> ATCGATTGTAC
CTAACTTAACA -> TAACTTAACAG
TAACAGCCTCC -> AACAGCCTCCG
ATATCGACCTG -> TATCGACCTGT
GACGGACACGA -> ACGGACACGAT
ACTCTGATGCC -> CTCTGATGCCT
AGGGGAGTACG -> GGGGAGTACGA
GTATTAGACCC -> TATTAGACCCA
ACAGGTTTATG -> CAGGTTTATGC
TGACACGTGCT -> GACACGTGCTA
AAATGCTATGT -> AATGCTATGTC
CTTGGAACGCT -> TTGGAACGCTT
CACCCCTACCA -> ACCCCTACCAC
CTAAGGCAAAT -> TAAGGCAAATG
GACAAGACTTC -> ACAAGACTTCT
GTGAGACGGAC -> TGAGACGGACA
CACACGGAACG -> ACACGGAACGG
GGCCGCTCTTT -> GCCGCTCTTTG
GTAGGTTATGC -> TAGGTTATGCG
GCTGGAGAAAC -> CTGGAGAAACA
CTGATGCCTTG -> TGATGCCTTGG
GTACCTCTGGC -> TACCTCTGGCT
TATGCCTCCGG -> ATGCCTCCGGA
TGTCGTATCAG -> GTCGTATCAGT
GTGGCCTATTA -> TGGCCTATTAC
AGTTCCGACAT -> GTTCCGACATG
TCTAAGTGACG -> CTAAGTGACGA
TCGCCTTACCG -> CGCCTTACCGA
CTTTATTGCCT -> TTTATTGCCTA
CAAATGTTACA -> AAATGTTACAC
TGAGACGGCCT -> GAGACGGCCTG
AAAGCGGGTGT -> AAGCGGGTGTC
TTCTAACCCTC -> TCTAACCCTCC
ACGGTTAAGTG -> CGGTTAAGTGA
ACAATCTGTAG -> CAATCTGTAGT
AGCTTAATATA -> GCTTAATATAC
CCAACAGCGGC -> CAACAGCGGCC
CACCTACTGGT -> ACCTACTGGTT
GTACCTACTGA -> TACCTACTGAG
AAATGAGCACT -> AATGAGCACTC
CCTCCGACAAC -> CTCCGACAACA
GCTGGCATACC -> CTGGCATACCA
AGATACTAGTG -> GATACTAGTGC
CGTGCTAGCAG -> GTGCTAGCAGA
ACCTCTGGCTT -> CCTCTGGCTTA
AACCGACGTTA -> ACCGACGTTAC
TGAGGTAGTGT -> GAGGTAGTGTC
GGCCACCCTTT -> GCCACCCTTTA
TGTGCAGTTCG -> GTGCAGTTCGT
TGCGATTTCTA -> GCGATTTCTAC
CGACGTTACCT -> GACGTTACCTG
TTTGGGGACCG -> TTGGGGACCGT
TCCGCTCGTTC -> CCGCTCGTTCC
CTGACCGATGC -> TGACCGATGCC
GGCGCTTATTA -> GCGCTTATTAT
CTTGGACCAGA -> TTGGACCAGAC
TATTATATCGA -> ATTATATCGAC
ATCTCGAGAGT -> TCTCGAGAGTC
ACACGGTGAGA -> CACGGTGAGAC
TGATGCCTTGG -> GATGCCTTGGA
TCCATGGTGCT -> CCATGGTGCTC
GTCTTTGTAGG -> TCTTTGTAGGT
ATTCAAAGGCC -> TTCAAAGGCCA
CAATGCGATTT -> AATGCGATTTC
TGCCCCATACA -> GCCCCATACAC
ACCGGTCCCCC -> CCGGTCCCCCG
ACACCGCCTAA -> CACCGCCTAAC
ACACCCCTACC -> CACCCCTACCA
TAAATGCTATG -> AAATGCTATGT
CGGAACGGATA -> GGAACGGATAC
AGTCAAAGCAG -> GTCAAAGCAGG
AACACGTCGGT -> ACACGTCGGTC
CTGGCCTGGCA -> TGGCCTGGCAG
CTCGCCCGTGT -> TCGCCCGTGTA
GGACCAGACCT -> GACCAGACCTC
TCCCGACCAGC -> CCCGACCAGCG
ACCGGGTTTCC -> CCGGGTTTCCA
TTGTGAGATGT -> TGTGAGATGTA
GCGATTTCTAC -> CGATTTCTACT
ATACACTTAAA -> TACACTTAAAC
CCTCTGGCTTA -> CTCTGGCTTAA
TGTCTGCCCGT -> GTCTGCCCGTA
ACATCGGCGCG -> CATCGGCGCGT
TGAGTATGGTG -> GAGTATGGTGT
CGCTCTTTGAA -> GCTCTTTGAAA
AAGCCGTACTA -> AGCCGTACTAC
TTAATATACGA -> TAATATACGAT
ACTCTTATAGC -> CTCTTATAGCC
TAGCCTCACGA -> AGCCTCACGAA
CAGGAGATACT -> AGGAGATACTA
TTGGGGACCGT -> TGGGGACCGTC
GACGTAGCTGA -> ACGTAGCTGAC
CCCAGACTAAC -> CCAGACTAACT
ACAACCACACG -> CAACCACACGG
CAGTTGACGAC -> AGTTGACGACA
AGTTGAAGGTG -> GTTGAAGGTGG
GGTGGCTTGCA -> GTGGCTTGCAG
TGTACAGGGGA -> GTACAGGGGAG
ACCTGGCCTGG -> CCTGGCCTGGC
ATGGCTGGAGA -> TGGCTGGAGAA
TGAATGTACAG -> GAATGTACAGG
GAGAGCAATGC -> AGAGCAATGCG
CTATGCCAGGA -> TATGCCAGGAT
ACTTTGGGGAC -> CTTTGGGGACC
GGCCTGAACCG -> GCCTGAACCGG
CGGACACGATT -> GGACACGATTA
TGCAGCACGGA -> GCAGCACGGAT
AAGTGGCAGTT -> AGTGGCAGTTG
CACGTCGGTCG -> ACGTCGGTCGG
AACCGGTCCCC -> ACCGGTCCCCC
GTACGCTACTC -> TACGCTACTCG
TGTTACACGGT -> GTTACACGGTG
CTATTACGCTG -> TATTACGCTGA
CTAGGACTCTG -> TAGGACTCTGA
TACAACCACAC -> ACAACCACACG
CAACCTGCGTT -> AACCTGCGTTC
ACATTGTGAGA -> CATTGTGAGAT
TCTTGAGCGGC -> CTTGAGCGGCT
CAGGCCGCTCT -> AGGCCGCTCTT
TGAAGGTGGCT -> GAAGGTGGCTT
GACGAATGTAT -> ACGAATGTATT
CCGATGTACCT -> CGATGTACCTA
TATTCCGCAGA -> ATTCCGCAGAG
AGGCCATGAAT -> GGCCATGAATA
CCTACGTAGTG -> CTACGTAGTGG
AGCCTCACGAA -> GCCTCACGAAA
TCCGCTAGTGT -> CCGCTAGTGTA
GCTCGTTCCTG -> CTCGTTCCTGT
TCGGCGAGCAT -> CGGCGAGCATA
AGACGGACACG -> GACGGACACGA
CCTGTGGAGTA -> CTGTGGAGTAT
CTGGCGCTTAT -> TGGCGCTTATT
CCACCTACGTA -> CACCTACGTAG
TCGTCTAAGTG -> CGTCTAAGTGA
TCTACTGAGTG -> CTACTGAGTGC
AGACCCAGACT -> GACCCAGACTA
TACTCGCCTTA -> ACTCGCCTTAC
TTCCTGTCTGG -> TCCTGTCTGGG
GGAAGCTGCGT -> GAAGCTGCGTG
TGCCTATGGCT -> GCCTATGGCTG
TCAAACCGGTC -> CAAACCGGTCC
AACGGTTAAGT -> ACGGTTAAGTG
ACGACAAGACT -> CGACAAGACTT
CCTGAGGTAGT -> CTGAGGTAGTG
TGGCATACCAC -> GGCATACCACG
CCGACCAGCGT -> CGACCAGCGTG
AGTTCGCATCG -> GTTCGCATCGG
GGTTCTCTTGT -> GTTCTCTTGTC
GAAACAACTTT -> AAACAACTTTG
CTATGGTTGTG -> TATGGTTGTGA
GTAGACAACAT -> TAGACAACATA
TATACCCTAAC -> ATACCCTAACT
ATGGATTCACA -> TGGATTCACAT
GGTCGAAGTCT -> GTCGAAGTCTG
CGAATGTATTA -> GAATGTATTAG
ACGGCTTGGGT -> CGGCTTGGGTT
ATTCACATCGG -> TTCACATCGGC
GAGCTTGAGAT -> AGCTTGAGATA
TATTACGCTGA -> ATTACGCTGAC
GCTTATTATAT -> CTTATTATATC
TTACCTGGTAT -> TACCTGGTATT
GGCTGCGTATA -> GCTGCGTATAT
TAGGCCACCCT -> AGGCCACCCTT
ACCAGACCTCC -> CCAGACCTCCC
AAGGCTCCGCT -> AGGCTCCGCTC
CCCCTACGCAG -> CCCTACGCAGC
AAGCCCACATT -> AGCCCACATTC
CTGCGTATATT -> TGCGTATATTC
CATCGGCGCGT -> ATCGGCGCGTC
TTAAATGAGCA -> TAAATGAGCAC
TACCCTAACTA -> ACCCTAACTAT
TTTTTTATCTC -> TTTTTATCTCG
TTCTAAGGCAA -> TCTAAGGCAAA
TAGCTGACTAG -> AGCTGACTAGG
TGCCTTGGACC -> GCCTTGGACCA
ACATAAAGGCT -> CATAAAGGCTC
GGTTGTGACAT -> GTTGTGACATT
TTACGCGCCGC -> TACGCGCCGCA
CTATACGATCT -> TATACGATCTC
CGACAACAAAA -> GACAACAAAAA
ACGCTGACGAA -> CGCTGACGAAT
AAGAGTTCGCA -> AGAGTTCGCAT
CCTGAACCGGG -> CTGAACCGGGT
CCTGGCAGCTG -> CTGGCAGCTGG
CCATCGTATGG -> CATCGTATGGA
TTTATTGCCTA -> TTATTGCCTAT
GTTCGCATCGG -> TTCGCATCGGC
ACGTCGGTCGG -> CGTCGGTCGGT
CGCAAAATCCA -> GCAAAATCCAG
AGCAATGCGAT -> GCAATGCGATT
CGTAAGGTACG -> GTAAGGTACGA
GTATATTCTTG -> TATATTCTTGT
TATCTCGGGGA -> ATCTCGGGGAA
TGCCCACCGAT -> GCCCACCGATG
ACTTAACAGCC -> CTTAACAGCCT
GCTGCGTGTGG -> CTGCGTGTGGA
CTGTACTAAGA -> TGTACTAAGAA
ATGAGCACTCC -> TGAGCACTCCC
CACGGATTCCT -> ACGGATTCCTA
AAGTAATTCAT -> AGTAATTCATG
CTCTTTGAAAC -> TCTTTGAAACC
GTGCAGCACGG -> TGCAGCACGGA
GTACGATGTGG -> TACGATGTGGC
CGATGCCCCAT -> GATGCCCCATA
CTCGAGAGTCA -> TCGAGAGTCAC
AAGTCTGACAC -> AGTCTGACACG
AATTGTCGTCT -> ATTGTCGTCTA
TAACTGAGTTG -> AACTGAGTTGT
GTATACACTTA -> TATACACTTAA
GGTGTGCCCTA -> GTGTGCCCTAG
ATGGGTAGTGT -> TGGGTAGTGTG
ATGAATAACCG -> TGAATAACCGA
TACTGAGTATG -> ACTGAGTATGG
GCATGCTGGCG -> CATGCTGGCGC
TGTCGTCGACA -> GTCGTCGACAG
GGTGAGACGGA -> GTGAGACGGAC
GCAGGGTTGAG -> CAGGGTTGAGA
ACCATCTTGAG -> CCATCTTGAGC
TCGGTCGGTAC -> CGGTCGGTACC
TCTCGCCCGTG -> CTCGCCCGTGT
GTATGGGTGTG -> TATGGGTGTGC
CTCGTTCCTGT -> TCGTTCCTGTC
GTCGTTTAAAT -> TCGTTTAAATG
GTTCGTGCTAC -> TTCGTGCTACG
CTATGGCTGGA -> TATGGCTGGAG
TTCGCATCGGC -> TCGCATCGGCG
AGCAGGGAAAA -> GCAGGGAAAAC
CGTCGACAGTT -> GTCGACAGTTC
GAGCAATGCGA -> AGCAATGCGAT
CTCAGCACTAA -> TCAGCACTAAA
TCTTCGAGGCC -> CTTCGAGGCCT
ATTGTTCTAAG -> TTGTTCTAAGG
GTATCAGTTGA -> TATCAGTTGAC
CCCACATTCAA -> CCACATTCAAA
GAGGTAGTGTC -> AGGTAGTGTCG
GGGACGACAAT -> GGACGACAATC
TCATGGCGGGG -> CATGGCGGGGT
GCGTGTGGACG -> CGTGTGGACGT
TCCGACATGAA -> CCGACATGAAT
CCCTACCACTC -> CCTACCACTCA
TGAGATGTAAT -> GAGATGTAATA
TCGGTACCTGG -> CGGTACCTGGA
ACGAAAGCGGG -> CGAAAGCGGGT
TAAGGCCAACA -> AAGGCCAACAG
ATACAACCTAG -> TACAACCTAGC
TCCTGACCGAT -> CCTGACCGATG
CCTCAATGATT -> CTCAATGATTA
CAGGTTTATGC -> AGGTTTATGCC
AAGCCGTCCTA -> AGCCGTCCTAT
TTGAGACGGCC -> TGAGACGGCCT
AGCACTCCCAC -> GCACTCCCACC
GCAGTTGAAGG -> CAGTTGAAGGT
TCCCTAATTGT -> CCCTAATTGTC
CCCATACACGA -> CCATACACGAT
TGGCTTAAATC -> GGCTTAAATCT
TGTCAAGCCGT -> GTCAAGCCGTA
GTCCTGAGGTA -> TCCTGAGGTAG
CGTATCAGTTG -> GTATCAGTTGA
CGTCCTACTAT -> GTCCTACTATG
AGTAATTCATG -> GTAATTCATGG
TGGCCTGGCAG -> GGCCTGGCAGC
CGTTCCTGTCT -> GTTCCTGTCTG
CCTCACGAAAG -> CTCACGAAAGC
CACCCGTCCTG -> ACCCGTCCTGA
AATCTACCATT -> ATCTACCATTT
CAACCTAGCGC -> AACCTAGCGCA
GTGATCACACC -> TGATCACACCG
CGTCGGTCGGT -> GTCGGTCGGTA
GATTCTCCATG -> ATTCTCCATGG
CTAGTCATTAA -> TAGTCATTAAT
GTAGTTCCGAC -> TAGTTCCGACA
TACCTGGAAGC -> ACCTGGAAGCA
AAAAAGCCGTC -> AAAAGCCGTCC
TCCACCTCTGT -> CCACCTCTGTA
ATACACTGCCT -> TACACTGCCTT
TGCGTTCGAGC -> GCGTTCGAGCC
GGTTGAGAGCA -> GTTGAGAGCAA
CTAACCCTCCC -> TAACCCTCCCG
TAGGTTCTCAG -> AGGTTCTCAGC
CTACTGAGTGC -> TACTGAGTGCA
ATTCTTGTATG -> TTCTTGTATGG
GCCTTGGAACG -> CCTTGGAACGC
CAACCACACGG -> AACCACACGGA
AGAGCAATGCG -> GAGCAATGCGA
CGGAAGCTGCG -> GGAAGCTGCGT
ATTCCTAGTCA -> TTCCTAGTCAT
CGAAAGTATCT -> GAAAGTATCTC
GCCACCCTTTA -> CCACCCTTTAT
ATCAAACCGGT -> TCAAACCGGTC
TGAGTGCAAGA -> GAGTGCAAGAG
TGTATTAGACC -> GTATTAGACCC
AGACGGCCTGA -> GACGGCCTGAA
TGCTCATAAAT -> GCTCATAAATG
GATACAACCTA -> ATACAACCTAG
GCAGGGAAAAC -> CAGGGAAAACG
TTATCTCGGGG -> TATCTCGGGGA
CGTAGTGGGTG -> GTAGTGGGTGA
AGGTTCTCAGC -> GGTTCTCAGCT
CGATCTCGCCC -> GATCTCGCCCG
ACCCAGACTAA -> CCCAGACTAAC
ATGTATTAGAC -> TGTATTAGACC
TGGTTTAACAC -> GGTTTAACACG
ATTTCTACTGA -> TTTCTACTGAG
ATCGTTACCGT -> TCGTTACCGTG
ATACGATCTCG -> TACGATCTCGC
TGGGGACCGTC -> GGGGACCGTCC
GGAGTACGACT -> GAGTACGACTC
GAGTCAAAGCA -> AGTCAAAGCAG
CGATTTCTACT -> GATTTCTACTG
ACGATTAGATT -> CGATTAGATTA
ACCCTAACTAT -> CCCTAACTATG
GCAGCAATGTT -> CAGCAATGTTT
TAATAATGGCT -> AATAATGGCTG
CCGATTCTCCA -> CGATTCTCCAT
ATGGAACGCAA -> TGGAACGCAAG
ATCTCGGGGAA -> TCTCGGGGAAT
GGCCCCTACGC -> GCCCCTACGCA
TGATCACACCG -> GATCACACCGC
ACCTATACGAT -> CCTATACGATC
GATTAGATTAG -> ATTAGATTAGG
ACCTACGTAGT -> CCTACGTAGTG
GACACGGTCAC -> ACACGGTCACG
TGGCTTGCAGG -> GGCTTGCAGGG
AGTCCTTGTCA -> GTCCTTGTCAT
GCCTTGTGCAG -> CCTTGTGCAGT
GAAGCAGCAAT -> AAGCAGCAATG
GGGTTGAGAGC -> GGTTGAGAGCA
GTGTCGTATCA -> TGTCGTATCAG
CTTGGGTTCTC -> TTGGGTTCTCT
TTATGCCTCCG -> TATGCCTCCGG
CGGGGTATTCT -> GGGGTATTCTA
CGATTGTACGC -> GATTGTACGCT
CTTGTCATTGT -> TTGTCATTGTT
GCGGCCTCAAT -> CGGCCTCAATG
CGGGTTTCCAC -> GGGTTTCCACC
TGAGATACAAC -> GAGATACAACC
GATCACACCGC -> ATCACACCGCC
CAGGGGAGTAC -> AGGGGAGTACG
TAAATCTACCA -> AAATCTACCAT
CGACTCTTATA -> GACTCTTATAG
GAATGCCCACC -> AATGCCCACCG
ACTACCTATAC -> CTACCTATACG
CCCCGGGAGGC -> CCCGGGAGGCA
AGCTGCGTGTG -> GCTGCGTGTGG
TCAAAGGCCAT -> CAAAGGCCATG
GGCCTGATGTC -> GCCTGATGTCA
CTAGCGCACCT -> TAGCGCACCTA
CAACATAAAGG -> AACATAAAGGC
CGGATACAACC -> GGATACAACCT
GGCAAATGTTA -> GCAAATGTTAC
GCCAGGATGAT -> CCAGGATGATA
TTGAGATACAA -> TGAGATACAAC
GGAGATACTAG -> GAGATACTAGT
AGCACGGATTC -> GCACGGATTCC
CACCTCTGTAC -> ACCTCTGTACT
CGTGTGGACGT -> GTGTGGACGTC
AGGCCGCTCTT -> GGCCGCTCTTT
TATACGATTAG -> ATACGATTAGA
CCAGAATCGTT -> CAGAATCGTTA
GCTAGTGTAGA -> CTAGTGTAGAC
GCTGGCGCTTA -> CTGGCGCTTAT
CCAGCGTGCAT -> CAGCGTGCATC
GTGTGCAGCAC -> TGTGCAGCACG
CTCAGCTGGCA -> TCAGCTGGCAT
GGTACAACCAC -> GTACAACCACA
CTTATAGCCTC -> TTATAGCCTCA
TTCTCAGCTGG -> TCTCAGCTGGC
ATGCGATTTCT -> TGCGATTTCTA
GCAGAGCTTGA -> CAGAGCTTGAG
TTCGGAGTCAA -> TCGGAGTCAAA
AGTGCGAAAGT -> GTGCGAAAGTA
GCTCATAAATG -> CTCATAAATGC
CCTATGGCTGG -> CTATGGCTGGA
CTAAGCCCACA -> TAAGCCCACAT
TACGATGTGGC -> ACGATGTGGCG
CACGGAACGGA -> ACGGAACGGAT
TTGTGCAGTTC -> TGTGCAGTTCG
ACCGTGGTTTT -> CCGTGGTTTTT
TTCAAAGGCCA -> TCAAAGGCCAT
CCCTCCCGATT -> CCTCCCGATTC
GGTTTATGCCT -> GTTTATGCCTC
ACCTCTGTACT -> CCTCTGTACTA
TTACCGTGGTT -> TACCGTGGTTT
CAGACTAACTG -> AGACTAACTGA
CCACATTCAAA -> CACATTCAAAG
ACACGATTACG -> CACGATTACGC
CTAGTGCGAAA -> TAGTGCGAAAG
ACAAGACTTCT -> CAAGACTTCTA
ACGACCTAAGC -> CGACCTAAGCC
GAATCTTCGAG -> AATCTTCGAGG
TTATTTTGGGA -> TATTTTGGGAC
CCATTTTGATC -> CATTTTGATCC
TTGTTCTAAGG -> TGTTCTAAGGC
TATATCGACCT -> ATATCGACCTG
CACGCTCCATC -> ACGCTCCATCG
CATTTTGATCC -> ATTTTGATCCC
TGTAAGAAGCT -> GTAAGAAGCTA
ACGACAATCTG -> CGACAATCTGT
CGATTAGGTTC -> GATTAGGTTCT
AACGCTTTCGG -> ACGCTTTCGGA
CTCGCCTTACC -> TCGCCTTACCG
TCCAGAATCGT -> CCAGAATCGTT
TAATTGTCGTC -> AATTGTCGTCT
TTCATGGCGGG -> TCATGGCGGGG
GGTTATGCGGG -> GTTATGCGGGA
TGCATCACGCT -> GCATCACGCTC
CAATCTGTAGT -> AATCTGTAGTC
GAACGCTTTCG -> AACGCTTTCGG
AAATGTTACAC -> AATGTTACACG
ATGTCGTCGAC -> TGTCGTCGACA
CTCAATGATTA -> TCAATGATTAT
GTGTGGACGTC -> TGTGGACGTCC
GGCTTGGGTTC -> GCTTGGGTTCT
ACGCTACTCGC -> CGCTACTCGCC
GTGGTTTTTTA -> TGGTTTTTTAT
ATACCCTAACT -> TACCCTAACTA
CCCTAACTATG -> CCTAACTATGT
CTGGCAGCTGG -> TGGCAGCTGGT
CTGGCTTAAAT -> TGGCTTAAATC
AATCGTTACCG -> ATCGTTACCGT
CGTATACACTT -> GTATACACTTA
ACTAACTGAGT -> CTAACTGAGTT
TTGGGACGACA -> TGGGACGACAA
ATTTTGATCCC -> TTTTGATCCCT
TATGGGTGTGC -> ATGGGTGTGCC
AAAACGGTTAA -> AAACGGTTAAG
ATACACGATTA -> TACACGATTAC
AGTTCGTGCTA -> GTTCGTGCTAC
CTCCCGACCAG -> TCCCGACCAGC
GCCTGGCAGCT -> CCTGGCAGCTG
GAGCACTCCCA -> AGCACTCCCAC
ACTAAGAACCG -> CTAAGAACCGT
GATGATACCTG -> ATGATACCTGG
ACATGAATTTG -> CATGAATTTGA
AGTTGTCGTTT -> GTTGTCGTTTA
GACAACATAAA -> ACAACATAAAG
TGACACGGTCA -> GACACGGTCAC
GCGTATATTCT -> CGTATATTCTT
TGGGACGACAA -> GGGACGACAAT
TGACGAGGCCG -> GACGAGGCCGC
CCGACATGAAT -> CGACATGAATT
GTAGTGTGCAG -> TAGTGTGCAGC
CACCGATGTAC -> ACCGATGTACC
GATTCACATCG -> ATTCACATCGG
TGGTGTCAAGC -> GGTGTCAAGCC
CCGTCCTGAGG -> CGTCCTGAGGT
GAGCATACACT -> AGCATACACTG
CGATGTGGCGC -> GATGTGGCGCC
ACCCGTCCTGA -> CCCGTCCTGAC
TTTCGGAGTCA -> TTCGGAGTCAA
CTGTCTGGGTC -> TGTCTGGGTCG
AATTCATGGCG -> ATTCATGGCGG
ATGGGTGTGCC -> TGGGTGTGCCC
CTGACGAATGT -> TGACGAATGTA
CGACAATCTGT -> GACAATCTGTA
TGCGTGTGGAC -> GCGTGTGGACG
GATTCCTAGTC -> ATTCCTAGTCA
TCTGATGCCTT -> CTGATGCCTTG
TACCTCTGGCT -> ACCTCTGGCTT
TCCTAGTCATT -> CCTAGTCATTA
GCTACGTAGTG -> CTACGTAGTGG
CGGCGCGTCCT -> GGCGCGTCCTG
CTATGTCGTCG -> TATGTCGTCGA
AGGTGGCTTGC -> GGTGGCTTGCA
GTCACGGCTTG -> TCACGGCTTGG
CTACTATGGTT -> TACTATGGTTG
AAATCATCGAT -> AATCATCGATT
TATCAGTTGAC -> ATCAGTTGACG
CTGTCTCGGAA -> TGTCTCGGAAG
CCATACACGAT -> CATACACGATT
GAATGTACAGG -> AATGTACAGGG
GAGTCACCCGT -> AGTCACCCGTC
TTGACGACAAG -> TGACGACAAGA
GAAGCTGCGTG -> AAGCTGCGTGT
TTGAATGTACA -> TGAATGTACAG
GGGAGTACGAC -> GGAGTACGACT
GCATCGGCGAG -> CATCGGCGAGC
TCGTATCAGTT -> CGTATCAGTTG
GCGCACCTACT -> CGCACCTACTG
CACCGCCTAAC -> ACCGCCTAACT
GCGGGTGTCCA -> CGGGTGTCCAG
GACGTCCTACT -> ACGTCCTACTA
GACCGATGCCC -> ACCGATGCCCC
TGTGACATTGT -> GTGACATTGTG
GATTACGCGCC -> ATTACGCGCCG
GCAGAACTCCG -> CAGAACTCCGC
GGTGTCCAGGC -> GTGTCCAGGCC
GTCGTCGACAG -> TCGTCGACAGT
GAGATACAACC -> AGATACAACCA
CCTATTACGCT -> CTATTACGCTG
GCGTGCATCAC -> CGTGCATCACG
CTGGAAGCAGC -> TGGAAGCAGCA
AACTTTGGGGA -> ACTTTGGGGAC
TTGTCGTCTAA -> TGTCGTCTAAG
TGGCCCCTACG -> GGCCCCTACGC
AGGTTATGCGG -> GGTTATGCGGG
TAATGGCTGCG -> AATGGCTGCGT
ATGCCTCCGGA -> TGCCTCCGGAA
TCCAGGCCGCT -> CCAGGCCGCTC
GGGGAGTACGA -> GGGAGTACGAC
GGAGGCAGGAG -> GAGGCAGGAGA
TATTTGTTACC -> ATTTGTTACCA
TGAATTTGAGA -> GAATTTGAGAC
ATAGCCTCACG -> TAGCCTCACGA
GAGCCATGACG -> AGCCATGACGT
CAAACCGGTCC -> AAACCGGTCCC
TTATGCGGGAC -> TATGCGGGACA
TGACTAGGACT -> GACTAGGACTC
GCCTGAACCGG -> CCTGAACCGGG
ACAGGGGAGTA -> CAGGGGAGTAC
CCAGACTAACT -> CAGACTAACTG
TTAGGCCACCC -> TAGGCCACCCT
AGGACTCTGAT -> GGACTCTGATG
TAAGCCCACAT -> AAGCCCACATT
GTGACGAGGCC -> TGACGAGGCCG
GTAGTGGCCTA -> TAGTGGCCTAT
TTGCCTATGGC -> TGCCTATGGCT
CTAAGTGACGA -> TAAGTGACGAG
AATGCGATTTC -> ATGCGATTTCT
ACGCAGCCTTG -> CGCAGCCTTGG
GCGCTTATTAT -> CGCTTATTATA
CTGCCCGTAGT -> TGCCCGTAGTT
ACTGGTTTAAC -> CTGGTTTAACA
AATATACGATT -> ATATACGATTA
CTCTTGTCTGC -> TCTTGTCTGCC
GGACCGTCCTG -> GACCGTCCTGA
AATCATCGATT -> ATCATCGATTG
GCCTTGGACCA -> CCTTGGACCAG
GTTACCGTGGT -> TTACCGTGGTT
AAGCTGCGTGT -> AGCTGCGTGTG
TCAATGATTAT -> CAATGATTATT
GTGTCCAGGCC -> TGTCCAGGCCG
CATGAATAACC -> ATGAATAACCG
TATTTTGGGAC -> ATTTTGGGACG
ACGCTCCATCG -> CGCTCCATCGT
GTTACCATCTT -> TTACCATCTTG
GTAGTGGGTGA -> TAGTGGGTGAT
GTCTGCCCGTA -> TCTGCCCGTAG
GATTGTACGCT -> ATTGTACGCTA
GTGCTCATAAA -> TGCTCATAAAT
AGCGGCCTCAA -> GCGGCCTCAAT
CCCGTATACAC -> CCGTATACACT
ATACAACCATC -> TACAACCATCA
AAACGGTTAAG -> AACGGTTAAGT
GCTAAGTGGCA -> CTAAGTGGCAG
ACAGTTCCACC -> CAGTTCCACCT
GGTTTAACACG -> GTTTAACACGT
TTGGGTTCTCT -> TGGGTTCTCTT
ATTCCGCAGAG -> TTCCGCAGAGC
AGGAGATACTA -> GGAGATACTAG
TACGCAGCCTT -> ACGCAGCCTTG
ATGGCGGGGTA -> TGGCGGGGTAT
AAAGGCCATGA -> AAGGCCATGAA
CCCCATACACG -> CCCATACACGA
ACCACTCAGCA -> CCACTCAGCAC
ATGTGGCGCCC -> TGTGGCGCCCG
TATTGCCTATG -> ATTGCCTATGG
CACGGTGAGAC -> ACGGTGAGACG
CGCCCGTGTAA -> GCCCGTGTAAG
CAGGGTTGAGA -> AGGGTTGAGAG
GGACGACAATC -> GACGACAATCT
GGCTAAGTGGC -> GCTAAGTGGCA
TTTGTAGGTTA -> TTGTAGGTTAT
CCTAACTATGT -> CTAACTATGTG
TCGTGCTACGT -> CGTGCTACGTA
GGAGAAACAAC -> GAGAAACAACT
GATCTCGCCCG -> ATCTCGCCCGT
TCACACCGCCT -> CACACCGCCTA
GTGTGCCCTAG -> TGTGCCCTAGA
CCATGACGTAG -> CATGACGTAGC
TGGAGAAACAA -> GGAGAAACAAC
ATCACGCTCCA -> TCACGCTCCAT
GTCCTATGCCA -> TCCTATGCCAG
ACCTCCCGACC -> CCTCCCGACCA
TGTCTCGGAAG -> GTCTCGGAAGT
TTGTAGGTTAT -> TGTAGGTTATG
ATCATCGATTG -> TCATCGATTGT
AACTCCGCTAG -> ACTCCGCTAGT
TGTCATTGTTC -> GTCATTGTTCT
TCTGTAGTCCT -> CTGTAGTCCTT
GATACTAGTGC -> ATACTAGTGCG
CTGAGTATGGT -> TGAGTATGGTG
CGGTCGGTACC -> GGTCGGTACCT
GCCCGTATACA -> CCCGTATACAC
CTGTGGAGTAT -> TGTGGAGTATT
CCCTAGAGGTA -> CCTAGAGGTAC
TGCCTTGTGCA -> GCCTTGTGCAG
AAGTGACGAGG -> AGTGACGAGGC
ATATTCTTGTA -> TATTCTTGTAT
CGATTAGATTA -> GATTAGATTAG
GACACGATTAG -> ACACGATTAGG
TCCGCAGAGCT -> CCGCAGAGCTT
GGTCCCCCGGG -> GTCCCCCGGGA
CTATGTGGCCC -> TATGTGGCCCC
CGCGCCGCAAA -> GCGCCGCAAAA
ACGTGCTAGCA -> CGTGCTAGCAG
TATGCCAGGAT -> ATGCCAGGATG
CTTGAGATACA -> TTGAGATACAA
TTGCAGGGTTG -> TGCAGGGTTGA
ATTAGGCCACC -> TTAGGCCACCC
CAAGACTTCTA -> AAGACTTCTAT
GCAAGCTTAAT -> CAAGCTTAATA
CCGCTAGTGTA -> CGCTAGTGTAG
AGCGCACCTAC -> GCGCACCTACT
GAAAGTATCTC -> AAAGTATCTCG
TCACGCTCCAT -> CACGCTCCATC
ATGCGGGACAC -> TGCGGGACACC
ATAACCGACGT -> TAACCGACGTT
AACGGATACAA -> ACGGATACAAC
ATGCTATGTCG -> TGCTATGTCGT
GCCTCCGACAA -> CCTCCGACAAC
CTCCATGGTGC -> TCCATGGTGCT
CGACCTGTGGA -> GACCTGTGGAG
GCAGTTCGTGC -> CAGTTCGTGCT
GAGTACGACTC -> AGTACGACTCT
TGGAAGCAGCA -> GGAAGCAGCAA
TGAGCGGCTAA -> GAGCGGCTAAG
CGCCTTACCGA -> GCCTTACCGAT
AGCTGACTAGG -> GCTGACTAGGA
CGTATGGATTC -> GTATGGATTCA
AGCAATGTTTT -> GCAATGTTTTT
TTGGAACGCTT -> TGGAACGCTTT
AGATACAACCA -> GATACAACCAT
ATGTCAGGGAA -> TGTCAGGGAAT
GACGACAAGAC -> ACGACAAGACT
GTGTAAGAAGC -> TGTAAGAAGCT
TAAGAACCGTG -> AAGAACCGTGC
GGTTTCCACCT -> GTTTCCACCTA
ACTCAGCACTA -> CTCAGCACTAA
CCGCTCGTTCC -> CGCTCGTTCCT
CTGGGTCGAAG -> TGGGTCGAAGT
AACGCAAGCTT -> ACGCAAGCTTA
GCCGTACTACC -> CCGTACTACCT
CCCGTCCTGAC -> CCGTCCTGACC
CGGTCCCCCGG -> GGTCCCCCGGG
ACACTTAAACA -> CACTTAAACAG
TTGATCCCTAA -> TGATCCCTAAT
GTGGCGCCCGT -> TGGCGCCCGTA
CTCGGGGAATC -> TCGGGGAATCT
ATGGTGCTCAT -> TGGTGCTCATA
CAATGATTATT -> AATGATTATTT
CCTTGTGCAGT -> CTTGTGCAGTT
GCAGCTGGTCT -> CAGCTGGTCTT
CATTGTGAGAT -> ATTGTGAGATG
CCTCCCGATTC -> CTCCCGATTCT
CGCCGCAAAAT -> GCCGCAAAATC
TCGTATGGATT -> CGTATGGATTC
GAGTATGGTGT -> AGTATGGTGTC
GAACCGGGTTT -> AACCGGGTTTC
ACCTGTGGAGT -> CCTGTGGAGTA
CCTAATTGTCG -> CTAATTGTCGT
CCACCTCTGTA -> CACCTCTGTAC
CTACCACTCAG -> TACCACTCAGC
ATTCTAACCCT -> TTCTAACCCTC
ATGATACCTGG -> TGATACCTGGC
AGGGTTGAGAG -> GGGTTGAGAGC
TCCTACTATGG -> CCTACTATGGT
TTATTATATCG -> TATTATATCGA
GCTTAATATAC -> CTTAATATACG
ACCATTTTGAT -> CCATTTTGATC
AACAGGTTTAT -> ACAGGTTTATG
CCCACCGATGT -> CCACCGATGTA
CGACAGTTCCA -> GACAGTTCCAC
GTCCTGTCTCG -> TCCTGTCTCGG
CTTCGAGGCCT -> TTCGAGGCCTG
TCGAGCCATGA -> CGAGCCATGAC
AGGATGATACC -> GGATGATACCT
GGAATCTTCGA -> GAATCTTCGAG
CTCCGCTCGTT -> TCCGCTCGTTC
TACTATGGTTG -> ACTATGGTTGT
CACGAAAGCGG -> ACGAAAGCGGG
GTCTGACACGG -> TCTGACACGGT
GCCTCCGGAAG -> CCTCCGGAAGC
GCAAATGTTAC -> CAAATGTTACA
ATGCCAGGATG -> TGCCAGGATGA
CGGCCTCAATG -> GGCCTCAATGA
CCGCAGAGCTT -> CGCAGAGCTTG
AATGTTACACG -> ATGTTACACGG
AGGTACGATGT -> GGTACGATGTG
GGATACAACCT -> GATACAACCTA
AGTCACCCGTC -> GTCACCCGTCC
TTTCTACTGAG -> TTCTACTGAGT
CCAACCTGCGT -> CAACCTGCGTT
TAAGGCAAATG -> AAGGCAAATGT
GCTACTCGCCT -> CTACTCGCCTT
CACATCGGCGC -> ACATCGGCGCG
TTAGGTTCTCA -> TAGGTTCTCAG
CCGTATACACT -> CGTATACACTT
CCGACGTTACC -> CGACGTTACCT
CGGTGAGACGG -> GGTGAGACGGA
TTTAAATGAGC -> TTAAATGAGCA
CGCTAGTGTAG -> GCTAGTGTAGA
TGGAACGCAAG -> GGAACGCAAGC
TACGACTCTTA -> ACGACTCTTAT
CTGCGTTCGAG -> TGCGTTCGAGC
CTCCGCTAGTG -> TCCGCTAGTGT
CTGGTTTAACA -> TGGTTTAACAC
GTTCGAGCCAT -> TTCGAGCCATG
GCACCTACTGG -> CACCTACTGGT
TAGGTTATGCG -> AGGTTATGCGG
CTAAATCATCG -> TAAATCATCGA
TGCCTCCGGAA -> GCCTCCGGAAG
CAAGCCGTACT -> AAGCCGTACTA
TTCTCTTGTCT -> TCTCTTGTCTG
AGTAAGGCCAA -> GTAAGGCCAAC
GCCGCAAAATC -> CCGCAAAATCC
CTCCCACCAAC -> TCCCACCAACC
GACTTCTATAC -> ACTTCTATACC
GAGATGTAATA -> AGATGTAATAA
CCTGTCTGGGT -> CTGTCTGGGTC
GCTCCGCTCGT -> CTCCGCTCGTT
CGGTCACGGCT -> GGTCACGGCTT
CATACACTGCC -> ATACACTGCCT
TGTCAGGGAAT -> GTCAGGGAATG
TGGCAGCTGGT -> GGCAGCTGGTC
CGCAGCCTTGG -> GCAGCCTTGGA
GCTGGTCTTTG -> CTGGTCTTTGT
AGGCCGCATGC -> GGCCGCATGCT
CCTACGCAGCC -> CTACGCAGCCT
AGCCATGACGT -> GCCATGACGTA
CCTCCGGAAGC -> CTCCGGAAGCT
TATAGCCTCAC -> ATAGCCTCACG
TTGAAACCAGT -> TGAAACCAGTA
GCTCTTTGAAA -> CTCTTTGAAAC
TTAGATTAGGC -> TAGATTAGGCC
AATGTATTAGA -> ATGTATTAGAC
TGTGGCGCCCG -> GTGGCGCCCGT
TTACGCTGACG -> TACGCTGACGA
ATGAATTTGAG -> TGAATTTGAGA
AGCGTGCATCA -> GCGTGCATCAC
TCCGACAACAA -> CCGACAACAAA
GCGCCCGTATA -> CGCCCGTATAC
TTACACGGTGA -> TACACGGTGAG
ATTAGATTAGG -> TTAGATTAGGC
GGTCACGGCTT -> GTCACGGCTTG
ATTACGCTGAC -> TTACGCTGACG
TCTTGTATGGG -> CTTGTATGGGT
TCGCCCGTGTA -> CGCCCGTGTAA
CATGCTGGCGC -> ATGCTGGCGCT
ATAATGGCTGC -> TAATGGCTGCG
TAGTCATTAAT -> AGTCATTAATA
TAAACAGGTTT -> AAACAGGTTTA
CTAAACGTACC -> TAAACGTACCT
GTCAGGGAATG -> TCAGGGAATGC
TAAATGAGCAC -> AAATGAGCACT
ACCGTGCGTAA -> CCGTGCGTAAG
CCTTGGACCAG -> CTTGGACCAGA
GACGGCCTGAA -> ACGGCCTGAAC
CTTGTGCAGTT -> TTGTGCAGTTC
CAGACCTCCCG -> AGACCTCCCGA
GGCGGGGTATT -> GCGGGGTATTC
AACCAGTAATG -> ACCAGTAATGG